sampno,vehno,gpsdiarycomplete,nbgpstripsdiaryday,nbdiaryreportedtrips,rawmatchdifference,nbmissinggpstrips,nbmissingdiarytrips,nbadjustedmissdiary
1038404,1,1,2,2,0,0,0,0
1038404,2,1,0,0,0,0,0,0
1039341,1,1,3,4,-1,1,0,0
1042241,1,1,3,2,1,1,2,2
1045672,1,1,3,2,1,0,1,1
1045672,2,1,0,0,0,0,0,0
1045672,3,1,1,2,-1,1,0,0
1050315,1,1,8,3,5,0,5,5
1050668,1,1,2,2,0,0,0,0
1050668,2,1,0,0,0,0,0,0
1053915,1,1,0,0,0,0,0,0
1055989,1,1,8,4,4,0,4,3
1055989,2,1,0,0,0,0,0,0
1056785,1,1,2,2,0,0,0,0
1056785,2,1,8,8,0,0,0,0
1056785,3,1,0,0,0,0,0,0
1058112,2,1,0,0,0,0,0,0
1119016,1,1,0,0,0,0,0,0
1119016,2,1,5,5,0,0,0,0
1119207,1,1,7,17,-10,10,0,0
1119207,2,1,0,0,0,0,0,0
1119231,1,1,8,7,1,0,1,1
1119626,1,1,0,0,0,0,0,0
1119626,2,1,4,4,0,0,0,0
1119973,1,1,0,0,0,0,0,0
1119973,2,1,3,3,0,0,0,0
1120621,1,1,0,0,0,0,0,0
1120621,2,1,9,7,2,0,2,2
1120672,1,1,5,5,0,0,0,0
1121840,1,1,10,11,-1,1,0,0
1122024,1,1,5,4,1,0,1,1
1122024,2,1,7,5,2,0,2,2
1122024,3,1,6,6,0,0,0,0
1122777,1,1,6,6,0,0,0,0
1122777,2,1,0,0,0,0,0,0
1123623,1,1,4,3,1,0,1,1
1123623,2,1,0,0,0,0,0,0
1123798,1,1,5,5,0,0,0,0
1123798,2,1,4,4,0,0,0,0
1123874,1,1,0,0,0,0,0,0
1123874,2,1,0,0,0,0,0,0
1124301,1,1,0,0,0,0,0,0
1124343,1,1,0,0,0,0,0,0
1124343,2,1,0,0,0,0,0,0
1124453,1,1,5,5,0,0,0,0
1124453,2,1,5,5,0,0,0,0
1124453,3,1,0,0,0,0,0,0
1124983,1,1,0,0,0,0,0,0
1124983,2,1,0,0,0,0,0,0
1126293,1,1,3,2,1,0,1,1
1126501,1,1,2,2,0,0,0,0
1126501,2,1,4,4,0,0,0,0
1126605,1,1,2,2,0,0,0,0
1126605,2,1,10,10,0,0,0,0
1126849,1,1,3,3,0,0,0,0
1127133,1,1,10,6,4,0,4,4
1127294,1,1,8,8,0,0,0,0
1127492,1,1,5,2,3,0,3,3
1128248,2,1,0,0,0,0,0,0
1128248,3,1,14,13,1,2,3,3
1128379,1,1,2,2,0,0,0,0
1128379,2,1,5,5,0,0,0,0
1128956,1,1,9,6,3,0,3,3
1129118,1,1,4,3,1,0,1,1
1129118,2,1,11,8,3,0,3,3
1129118,3,1,13,12,1,0,1,1
1129134,2,1,6,4,2,0,2,2
1129619,1,1,0,0,0,0,0,0
1129619,2,1,0,0,0,0,0,0
1130096,1,1,10,9,1,0,1,1
1130096,2,1,8,7,1,3,4,3
1130232,1,1,7,9,-2,2,0,0
1130319,1,1,4,4,0,0,0,0
1131986,1,1,6,6,0,1,1,0
1132372,1,1,7,8,-1,2,2,2
1132372,2,1,0,0,0,0,0,0
1132952,1,1,0,0,0,0,0,0
1132952,2,1,13,7,6,0,6,6
1132952,3,1,8,7,1,0,1,1
1133768,1,1,0,0,0,0,0,0
1133768,2,1,6,4,2,0,2,2
1133768,3,1,0,0,0,0,0,0
1134112,2,1,9,6,3,0,3,3
1134675,1,1,4,4,0,0,0,0
1134675,2,1,5,4,1,0,1,1
1135474,1,1,8,11,-3,3,0,0
1135474,2,1,0,0,0,0,0,0
1135474,3,1,0,0,0,0,0,0
1136575,1,1,4,4,0,0,0,0
1137262,1,1,8,10,-2,3,1,1
1137262,2,1,4,4,0,0,0,0
1137279,1,1,0,0,0,0,0,0
1137279,2,1,0,0,0,0,0,0
1137279,3,1,0,0,0,0,0,0
1138332,1,1,0,0,0,0,0,0
1138332,2,1,3,2,1,0,1,1
1138345,1,1,6,6,0,0,0,0
1138345,2,1,0,0,0,0,0,0
1138411,2,1,2,2,0,0,0,0
1138558,2,1,0,0,0,0,0,0
1139518,1,1,0,0,0,0,0,0
1139518,2,1,0,0,0,0,0,0
1140389,1,1,10,10,0,0,0,0
1140389,2,1,16,11,5,0,5,3
1140389,3,1,0,0,0,0,0,0
1141150,1,1,9,7,2,0,2,2
1141150,2,1,4,4,0,0,0,0
1141774,1,1,9,9,0,0,0,0
1141774,2,1,0,0,0,0,0,0
1141774,3,1,4,6,-2,3,1,1
1142269,1,1,2,2,0,0,0,0
1142269,2,1,2,2,0,0,0,0
1142842,1,1,7,2,5,0,5,5
1142842,2,1,1,4,-3,3,0,0
1143304,1,1,0,0,0,0,0,0
1144105,1,1,0,0,0,0,0,0
1144105,3,1,0,0,0,0,0,0
1144417,1,1,5,5,0,0,0,0
1144417,2,1,0,0,0,0,0,0
1144458,1,1,9,8,1,0,1,1
1144458,2,1,0,0,0,0,0,0
1144540,1,1,0,0,0,0,0,0
1144963,1,1,5,4,1,0,1,1
1145192,1,1,3,3,0,0,0,0
1146006,1,1,2,2,0,0,0,0
1146475,1,1,0,0,0,0,0,0
1146601,1,1,3,4,-1,1,0,0
1147103,1,1,11,6,5,0,5,5
1147643,1,1,5,1,4,0,4,4
1147739,1,1,10,4,6,0,6,5
1148471,1,1,15,16,-1,2,1,1
1148481,1,1,2,2,0,0,0,0
1148481,2,1,0,0,0,0,0,0
1148958,1,1,2,2,0,0,0,0
1148958,2,1,3,3,0,0,0,0
1148958,3,1,0,0,0,0,0,0
1149240,1,1,1,3,-2,2,0,0
1149240,2,1,0,0,0,0,0,0
1149246,1,1,0,0,0,0,0,0
1149246,2,1,0,0,0,0,0,0
1150733,2,1,8,8,0,0,0,0
1150733,3,1,0,0,0,0,0,0
1151218,1,1,12,11,1,0,1,1
1151218,2,1,0,0,0,0,0,0
1151247,1,1,0,0,0,0,0,0
1151703,1,1,4,6,-2,2,0,0
1151703,2,1,4,2,2,0,2,2
1152193,1,1,2,2,0,0,0,0
1152193,2,1,3,3,0,0,0,0
1152277,1,1,5,5,0,0,0,0
1152893,1,1,18,14,4,0,4,3
1153899,1,1,6,2,4,0,4,4
1153899,2,1,8,11,-3,3,0,0
1154287,1,1,3,3,0,0,0,0
1154600,1,1,4,4,0,0,0,0
1154604,1,1,11,10,1,1,2,2
1154604,2,1,6,5,1,0,1,1
1154779,1,1,0,0,0,0,0,0
1154779,2,1,0,0,0,0,0,0
1154779,3,1,0,0,0,0,0,0
1154833,1,1,4,4,0,0,0,0
1154990,2,1,3,3,0,0,0,0
1155500,1,1,4,2,2,0,2,2
1155500,2,1,0,0,0,0,0,0
1155952,1,1,0,0,0,0,0,0
1155952,2,1,0,0,0,0,0,0
1156375,1,1,8,8,0,0,0,0
1156375,2,1,4,5,-1,1,0,0
1156589,1,1,4,3,1,0,1,1
1156589,2,1,0,0,0,0,0,0
1156667,1,1,10,8,2,0,2,2
1156667,2,1,4,4,0,0,0,0
1156667,3,1,3,3,0,0,0,0
1156916,1,1,2,2,0,0,0,0
1157729,1,1,2,2,0,0,0,0
1157729,2,1,4,4,0,0,0,0
1158702,1,1,3,3,0,0,0,0
1159125,1,1,12,4,8,0,8,8
1159125,2,1,3,3,0,0,0,0
1159125,3,1,0,0,0,0,0,0
1159162,2,1,0,0,0,0,0,0
1159162,3,1,1,1,0,0,0,0
1159473,1,1,0,0,0,0,0,0
1159473,2,1,3,3,0,0,0,0
1159701,1,1,10,9,1,0,1,1
1159701,2,1,3,2,1,0,1,1
1159701,3,1,0,0,0,0,0,0
1160012,2,1,0,0,0,0,0,0
1160012,3,1,0,0,0,0,0,0
1160012,4,1,12,12,0,0,0,0
1160215,1,1,9,4,5,0,5,4
1160215,2,1,0,0,0,0,0,0
1160271,2,1,0,0,0,0,0,0
1160271,3,1,0,0,0,0,0,0
1160708,1,1,2,2,0,0,0,0
1160708,2,1,7,4,3,0,3,3
1161001,1,1,4,4,0,0,0,0
1161001,2,1,0,0,0,0,0,0
1161003,2,1,0,0,0,0,0,0
1161533,1,1,2,2,0,0,0,0
1161533,2,1,10,4,6,0,6,6
1161576,1,1,0,0,0,0,0,0
1161576,2,1,0,0,0,0,0,0
1161632,2,1,9,9,0,0,0,0
1161794,1,1,11,6,5,1,6,5
1162146,1,1,2,2,0,0,0,0
1162192,1,1,4,2,2,0,2,2
1162192,2,1,0,0,0,0,0,0
1162242,1,1,3,2,1,1,2,2
1162516,1,1,8,7,1,0,1,1
1162516,2,1,2,2,0,0,0,0
1162572,1,1,2,2,0,0,0,0
1162685,1,1,6,6,0,0,0,0
1162685,3,1,0,0,0,0,0,0
1163282,1,1,5,5,0,0,0,0
1163282,2,1,4,4,0,0,0,0
1163332,1,1,0,0,0,0,0,0
1163332,2,1,4,4,0,0,0,0
1163459,1,1,7,6,1,0,1,1
1163459,2,1,2,2,0,0,0,0
1164087,1,1,2,2,0,0,0,0
1164236,1,1,0,0,0,0,0,0
1164236,2,1,0,0,0,0,0,0
1164413,1,1,17,14,3,0,3,2
1164413,2,1,2,2,0,0,0,0
1164754,1,1,6,5,1,0,1,1
1165006,1,1,0,0,0,0,0,0
1165342,1,1,7,7,0,0,0,0
1165383,1,1,4,4,0,0,0,0
1166002,1,1,1,1,0,0,0,0
1166010,1,1,0,0,0,0,0,0
1166129,1,1,2,2,0,0,0,0
1166129,2,1,10,10,0,0,0,0
1166240,1,1,2,1,1,0,1,1
1166621,1,1,0,0,0,0,0,0
1167174,1,1,2,2,0,0,0,0
1167174,2,1,6,5,1,0,1,1
1167270,1,1,2,2,0,0,0,0
1167270,2,1,2,2,0,0,0,0
1167895,1,1,0,0,0,0,0,0
1167895,3,1,3,2,1,1,2,2
1167935,2,1,0,0,0,0,0,0
1168317,2,1,3,2,1,1,2,2
1169399,1,1,7,4,3,0,3,3
1169433,2,1,1,1,0,0,0,0
1169627,1,1,5,6,-1,1,0,0
1169627,2,1,0,0,0,0,0,0
1169730,1,1,4,8,-4,4,0,0
1169730,2,1,3,5,-2,2,0,0
1169789,1,1,10,10,0,0,0,0
1169789,2,1,4,3,1,0,1,1
1169881,1,1,2,9,-7,7,0,0
1169881,2,1,2,2,0,0,0,0
1170111,1,1,0,0,0,0,0,0
1170507,1,1,9,2,7,0,7,7
1170997,1,1,0,0,0,0,0,0
1170997,2,1,22,7,15,0,15,15
1171332,1,1,4,4,0,0,0,0
1171332,2,1,5,5,0,0,0,0
1171478,1,1,4,4,0,0,0,0
1171478,2,1,5,5,0,0,0,0
1171742,1,1,0,0,0,0,0,0
1172270,1,1,2,4,-2,2,0,0
1172270,2,1,0,0,0,0,0,0
1172270,4,1,5,2,3,0,3,3
1172703,1,1,7,7,0,0,0,0
1172873,1,1,5,2,3,0,3,3
1172970,2,1,0,0,0,0,0,0
1172970,3,1,17,13,4,1,5,5
1173051,1,1,4,4,0,0,0,0
1173051,2,1,6,4,2,0,2,1
1173408,1,1,11,6,5,0,5,5
1173408,2,1,2,3,-1,1,0,0
1173481,1,1,6,6,0,0,0,0
1173481,2,1,0,0,0,0,0,0
1173661,1,1,6,7,-1,1,0,0
1173661,2,1,6,6,0,0,0,0
1173661,3,1,2,2,0,0,0,0
1173827,1,1,3,3,0,0,0,0
1173827,2,1,3,2,1,0,1,1
1173827,3,1,0,0,0,0,0,0
1174107,2,1,0,0,0,0,0,0
1174569,1,1,4,5,-1,2,1,1
1174958,1,1,11,11,0,0,0,0
1174958,2,1,4,4,0,0,0,0
1175309,1,1,4,4,0,0,0,0
1175309,2,1,0,0,0,0,0,0
1176852,1,1,11,11,0,0,0,0
1180182,1,1,5,5,0,0,0,0
1181189,1,1,5,6,-1,1,0,0
1181189,2,1,2,2,0,0,0,0
1187627,1,1,15,6,9,0,9,9
1187627,2,1,0,0,0,0,0,0
1210979,1,1,2,2,0,0,0,0
1210979,2,1,5,5,0,0,0,0
1212582,1,1,7,7,0,0,0,0
1215004,1,1,5,5,0,0,0,0
1216646,1,1,2,2,0,0,0,0
1228847,1,1,10,10,0,0,0,0
1228847,2,1,3,4,-1,1,0,0
1234711,1,1,6,6,0,0,0,0
1235900,1,1,4,5,-1,1,0,0
1238683,1,1,14,14,0,0,0,0
1243931,1,1,3,3,0,0,0,0
1251576,1,1,0,0,0,0,0,0
1251576,2,1,4,4,0,0,0,0
1264944,4,1,7,2,5,0,5,5
1264944,5,1,0,0,0,0,0,0
1273244,1,1,2,2,0,0,0,0
1273244,2,1,8,8,0,0,0,0
1283264,1,1,2,2,0,0,0,0
1283264,2,1,0,1,-1,1,0,0
1283264,3,1,5,5,0,0,0,0
1313865,1,1,2,2,0,0,0,0
1313865,2,1,3,3,0,0,0,0
1331708,1,1,10,9,1,1,2,2
1331708,2,1,4,8,-4,5,1,1
1333310,1,1,0,0,0,0,0,0
1333310,2,1,0,0,0,0,0,0
1333310,3,1,0,0,0,0,0,0
1333514,1,1,6,6,0,0,0,0
1333514,2,1,4,4,0,1,0,0
1340013,1,1,0,0,0,0,0,0
1342466,1,1,7,5,2,0,2,1
1342466,2,1,0,0,0,0,0,0
1342466,3,1,2,2,0,0,0,0
1344212,1,1,0,0,0,0,0,0
1344212,3,1,1,4,-3,3,0,0
1349255,1,1,2,2,0,0,0,0
1351409,2,1,5,5,0,0,0,0
1370191,1,1,0,0,0,0,0,0
1370191,2,1,0,0,0,0,0,0
1370191,3,1,0,0,0,0,0,0
1399915,1,1,3,2,1,0,1,1
1399915,2,1,0,0,0,0,0,0
1406500,1,1,3,3,0,0,0,0
1407344,2,1,11,10,1,1,0,0
1415218,1,1,7,8,-1,1,0,0
1415629,1,1,3,3,0,0,0,0
1415629,2,1,5,5,0,0,0,0
1415629,3,1,0,0,0,0,0,0
1416183,1,1,4,4,0,0,0,0
1416183,2,1,4,3,1,0,1,1
1420962,1,1,0,0,0,0,0,0
1420962,2,1,3,3,0,0,0,0
1421489,1,1,8,8,0,0,0,0
1421489,2,1,7,5,2,0,2,2
1427372,1,1,6,5,1,0,1,0
1427372,2,1,5,5,0,0,0,0
1427372,3,1,0,0,0,0,0,0
1439344,1,1,7,6,1,0,1,1
1439344,2,1,8,8,0,0,0,0
1443365,1,1,1,2,-1,1,0,0
1443511,1,1,2,2,0,0,0,0
1451414,1,1,4,6,-2,2,0,0
1455216,1,1,5,5,0,0,0,0
1461164,1,1,2,2,0,0,0,0
1467769,1,1,0,0,0,0,0,0
1467769,2,1,0,0,0,0,0,0
1468270,1,1,6,6,0,0,0,0
1468270,2,1,4,4,0,0,0,0
1468270,3,1,4,4,0,0,0,0
1475763,1,1,0,0,0,0,0,0
1497277,1,1,2,2,0,0,0,0
1497277,2,1,5,5,0,0,0,0
1517085,1,1,0,0,0,0,0,0
1522062,1,1,6,7,-1,1,0,0
1525127,1,1,4,4,0,0,0,0
1527801,2,1,0,0,0,0,0,0
1676291,1,1,5,3,2,0,2,2
1676984,1,1,8,2,6,0,6,6
1677386,1,1,0,0,0,0,0,0
1677386,2,1,0,0,0,0,0,0
1677386,3,1,0,0,0,0,0,0
1678928,1,1,7,7,0,0,0,0
1678928,2,1,8,8,0,0,0,0
1681919,1,1,12,9,3,0,3,3
1683815,1,1,9,7,2,0,2,2
1683815,2,1,5,5,0,0,0,0
1683964,1,1,9,1,8,0,8,8
1683964,2,1,0,0,0,0,0,0
1684031,1,1,2,2,0,0,0,0
1684031,2,1,0,0,0,0,0,0
1684086,1,1,3,2,1,0,1,1
1684086,2,1,2,2,0,0,0,0
1684473,1,1,7,6,1,0,1,1
1684473,2,1,4,3,1,0,1,0
1685393,1,1,3,3,0,0,0,0
1685393,2,1,4,3,1,0,1,1
1685846,1,1,2,2,0,0,0,0
1685972,1,1,7,6,1,0,1,1
1686381,1,1,0,0,0,0,0,0
1687029,3,1,0,0,0,0,0,0
1688099,1,1,8,8,0,0,0,0
1688099,2,1,0,0,0,0,0,0
1689211,1,1,0,0,0,0,0,0
1689211,2,1,13,3,10,0,10,10
1689780,1,1,7,6,1,0,1,1
1689793,2,1,0,0,0,0,0,0
1690497,1,1,20,18,2,0,2,2
1692673,1,1,6,6,0,0,0,0
1692673,2,1,6,6,0,1,1,1
1693343,1,1,5,2,3,0,3,3
1693343,2,1,8,8,0,0,0,0
1694498,1,1,9,9,0,0,0,0
1694498,2,1,14,11,3,1,4,1
1694686,1,1,0,0,0,0,0,0
1694686,3,1,0,0,0,0,0,0
1695315,1,1,4,4,0,0,0,0
1696302,1,1,2,2,0,0,0,0
1697188,1,1,5,5,0,0,0,0
1697957,3,1,8,6,2,2,4,1
1699274,1,1,2,2,0,0,0,0
1700848,1,1,9,7,2,0,2,2
1700848,2,1,3,3,0,0,0,0
1701147,2,1,2,2,0,0,0,0
1701883,1,1,9,5,4,0,4,4
1701883,2,1,0,0,0,0,0,0
1702144,1,1,12,10,2,0,2,2
1704646,1,1,5,4,1,0,1,0
1704646,2,1,4,3,1,0,1,1
1704646,3,1,12,9,3,0,3,3
1705614,1,1,4,4,0,0,0,0
1705614,2,1,8,8,0,0,0,0
1706927,1,1,2,2,0,0,0,0
1706927,2,1,15,5,10,0,10,6
1708135,1,1,6,4,2,0,2,2
1708135,2,1,2,2,0,0,0,0
1710195,1,1,6,2,4,0,4,3
1710600,1,1,2,2,0,0,0,0
1711504,1,1,4,5,-1,1,0,0
1712618,1,1,19,10,9,0,9,9
1712618,2,1,2,2,0,0,0,0
1712621,1,1,0,0,0,0,0,0
1712621,2,1,0,0,0,0,0,0
1714824,2,1,0,0,0,0,0,0
1715267,2,1,0,0,0,0,0,0
1715353,2,1,0,0,0,0,0,0
1716044,1,1,8,5,3,0,3,3
1716758,1,1,0,0,0,0,0,0
1716758,2,1,0,0,0,0,0,0
1716758,3,1,9,5,4,0,4,3
1717584,1,1,4,4,0,0,0,0
1717584,2,1,6,6,0,0,0,0
1717584,3,1,0,0,0,0,0,0
1717773,1,1,15,9,6,0,6,6
1717773,2,1,0,0,0,0,0,0
1718195,1,1,3,2,1,0,1,1
1718195,2,1,0,0,0,0,0,0
1718975,1,1,0,0,0,0,0,0
1719338,1,1,10,7,3,0,3,1
1719645,1,1,8,10,-2,3,1,1
1719876,1,1,6,5,1,0,1,1
1722105,1,1,19,13,6,0,6,5
1723368,1,1,12,4,8,0,8,7
1723368,2,1,13,6,7,2,10,10
1723377,1,1,2,2,0,0,0,0
1723377,2,1,0,0,0,0,0,0
1725642,1,1,3,3,0,0,0,0
1725642,2,1,6,6,0,0,0,0
1726019,1,1,11,6,5,2,7,7
1726711,1,1,4,3,1,0,1,1
1726711,2,1,2,2,0,0,0,0
1726711,3,1,4,4,0,0,0,0
1727269,2,1,4,3,1,0,1,0
1727269,3,1,0,0,0,0,0,0
1728928,1,1,7,6,1,0,1,1
1728928,2,1,4,3,1,0,1,1
1729710,4,1,0,0,0,0,0,0
1730453,1,1,3,3,0,0,0,0
1730453,2,1,2,2,0,0,0,0
1731816,1,1,6,3,3,0,4,4
1732821,2,1,11,11,0,0,0,0
1732821,3,1,5,5,0,0,0,0
1734264,1,1,12,11,1,0,1,1
1734598,1,1,5,2,3,0,3,3
1734598,2,1,1,1,0,0,0,0
1734853,2,1,7,6,1,0,1,0
1736384,1,1,0,0,0,0,0,0
1736384,4,1,0,0,0,0,0,0
1739459,1,1,5,4,1,2,3,3
1739459,3,1,7,7,0,4,4,4
1740001,1,1,2,2,0,0,0,0
1742415,1,1,0,0,0,0,0,0
1742415,2,1,0,0,0,0,0,0
1742479,1,1,5,5,0,0,0,0
1742479,2,1,4,4,0,0,0,0
1742548,1,1,3,3,0,0,0,0
1742548,3,1,0,0,0,0,0,0
1743485,1,1,5,4,1,0,1,1
1743485,2,1,0,0,0,0,0,0
1745266,1,1,8,7,1,0,1,1
1745311,1,1,7,6,1,0,1,1
1745311,2,1,10,9,1,2,3,3
1745311,3,1,11,6,5,1,6,6
1748256,1,1,4,6,-2,2,0,0
1748256,2,1,15,10,5,0,5,4
1751111,1,1,7,7,0,0,0,0
1751111,2,1,0,0,0,0,0,0
1751645,2,1,0,0,0,0,0,0
1752204,1,1,6,6,0,0,0,0
1752204,2,1,0,0,0,0,0,0
1752928,1,1,2,2,0,0,0,0
1752928,2,1,4,4,0,0,0,0
1753149,1,1,6,4,2,0,2,2
1753158,1,1,2,2,0,0,0,0
1753158,2,1,2,2,0,0,0,0
1753355,1,1,6,3,3,0,3,3
1753355,2,1,0,0,0,0,0,0
1754852,2,1,7,7,0,0,0,0
1754852,3,1,2,2,0,0,0,0
1755363,1,1,0,0,0,0,0,0
1755363,2,1,0,0,0,0,0,0
1755429,1,1,6,6,0,3,3,3
1755429,2,1,0,0,0,0,0,0
1756099,1,1,12,12,0,0,0,0
1756099,2,1,5,6,-1,2,1,1
1756279,1,1,6,2,4,0,4,4
1756279,3,1,1,2,-1,1,0,0
1757757,1,1,0,0,0,0,0,0
1757757,2,1,0,0,0,0,0,0
1757798,1,1,0,0,0,0,0,0
1757798,2,1,11,7,4,1,5,5
1759225,2,1,0,0,0,0,0,0
1759981,1,1,3,2,1,0,1,1
1759981,2,1,6,6,0,0,0,0
1761022,1,1,0,0,0,0,0,0
1761552,2,1,0,0,0,0,0,0
1761597,1,1,0,0,0,0,0,0
1761597,2,1,2,2,0,0,0,0
1761597,3,1,0,0,0,0,0,0
1763693,1,1,2,2,0,0,0,0
1763693,2,1,9,9,0,0,0,0
1763752,1,1,4,2,2,0,2,2
1763752,2,1,0,0,0,0,0,0
1764400,1,1,0,0,0,0,0,0
1765460,1,1,6,6,0,0,0,0
1765460,4,1,5,4,1,1,2,2
1766684,1,1,5,4,1,0,1,1
1766684,2,1,2,3,-1,1,0,0
1768298,1,1,7,3,4,0,4,4
1769988,1,1,2,3,-1,1,0,0
1771678,1,1,0,0,0,0,0,0
1771678,2,1,0,0,0,0,0,0
1772229,1,1,4,3,1,0,1,1
1772229,2,1,0,0,0,0,0,0
1773325,1,1,5,4,1,0,1,1
1773325,2,1,0,0,0,0,0,0
1774534,2,1,0,0,0,0,0,0
1775857,1,1,0,0,0,0,0,0
1775857,2,1,0,0,0,0,0,0
1776090,1,1,8,8,0,0,0,0
1776090,2,1,14,13,1,0,1,1
1776781,1,1,0,0,0,0,0,0
1776781,2,1,4,2,2,0,2,2
1778872,1,1,8,6,2,0,2,2
1778872,2,1,3,3,0,0,0,0
1792524,1,1,2,2,0,0,0,0
1792524,2,1,3,3,0,0,0,0
1801064,1,1,6,4,2,1,3,3
1801064,2,1,2,2,0,0,0,0
1818989,1,1,2,2,0,0,0,0
1818989,2,1,4,3,1,0,1,0
1821132,1,1,2,2,0,0,0,0
1825537,1,1,6,5,1,0,1,1
1834977,2,1,3,3,0,0,0,0
1850151,1,1,6,5,1,0,1,1
1850151,2,1,0,0,0,0,0,0
1879741,1,1,0,0,0,0,0,0
1879741,2,1,2,1,1,0,1,1
1882684,1,1,0,0,0,0,0,0
1882684,2,1,0,0,0,0,0,0
1898630,1,1,9,6,3,0,3,3
1898857,1,1,3,3,0,0,0,0
1898857,2,1,3,2,1,0,1,1
1898857,3,1,10,9,1,0,1,1
1906949,1,1,3,2,1,0,1,1
1911716,1,1,0,0,0,0,0,0
1935627,1,1,1,2,-1,1,0,0
1935627,2,1,0,0,0,0,0,0
1935764,1,1,3,4,-1,1,0,0
1935764,2,1,0,0,0,0,0,0
1945957,1,1,3,3,0,0,0,0
1945957,2,1,9,9,0,0,0,0
1950427,1,1,2,2,0,0,0,0
1950427,2,1,12,12,0,0,0,0
1952246,2,1,6,5,1,0,1,1
1953496,2,1,6,5,1,0,1,1
1984360,2,1,6,5,1,0,1,1
2001893,1,1,8,6,2,0,2,2
2001893,2,1,5,4,1,0,1,1
2013804,1,1,3,3,0,0,0,0
2013804,2,1,0,0,0,0,0,0
2013936,1,1,5,4,1,0,1,0
2013936,2,1,7,4,3,0,3,1
2015725,1,1,3,2,1,0,1,1
2015725,2,1,0,0,0,0,0,0
2016809,1,1,4,4,0,0,0,0
2016809,2,1,2,2,0,0,0,0
2017953,1,1,7,7,0,0,0,0
2018748,1,1,8,9,-1,1,0,0
2019976,1,1,15,12,3,0,4,4
2019976,2,1,0,0,0,0,0,0
2020299,2,1,4,2,2,0,2,2
2020299,3,1,0,0,0,0,0,0
2022067,1,1,15,12,3,1,4,4
2022648,2,1,2,2,0,0,0,0
2026840,1,1,0,0,0,0,0,0
2026840,2,1,0,0,0,0,0,0
2030435,1,1,5,5,0,0,0,0
2030860,1,1,4,4,0,0,0,0
2030860,2,1,7,7,0,0,0,0
2030992,1,1,0,0,0,0,0,0
2030992,2,1,0,0,0,0,0,0
2031072,1,1,3,3,0,0,0,0
2031072,2,1,3,3,0,0,0,0
2031840,1,1,8,6,2,0,2,2
2031840,2,1,7,4,3,1,4,4
2031928,1,1,0,0,0,0,0,0
2031928,2,1,13,3,10,0,10,9
2032700,1,1,2,2,0,0,0,0
2032700,2,1,6,6,0,0,0,0
2035362,2,1,0,0,0,0,0,0
2038553,2,1,17,5,12,1,13,12
2038553,3,1,19,11,8,1,9,9
2041686,1,1,6,7,-1,3,2,2
2042915,1,1,3,3,0,0,0,0
2043295,1,1,10,5,5,0,5,5
2043295,2,1,3,4,-1,2,1,1
2043654,1,1,0,0,0,0,0,0
2043654,2,1,6,6,0,0,0,0
2045058,1,1,3,3,0,0,0,0
2045371,2,1,0,0,0,0,0,0
2045371,4,1,0,0,0,0,0,0
2049177,1,1,7,5,2,0,2,2
2051540,1,1,4,4,0,0,0,0
2053880,1,1,4,3,1,0,1,1
2053880,2,1,0,0,0,0,0,0
2054601,1,1,0,0,0,0,0,0
2055436,1,1,4,4,0,0,0,0
2055559,1,1,5,5,0,0,0,0
2057248,1,1,2,2,0,0,0,0
2057248,2,1,5,6,-1,1,0,0
2058453,1,1,5,4,1,0,1,1
2060325,1,1,4,3,1,0,1,0
2060325,2,1,6,7,-1,1,0,0
2060862,1,1,2,2,0,0,0,0
2061900,1,1,0,0,0,0,0,0
2061900,2,1,0,0,0,0,0,0
2063634,1,1,2,2,0,0,0,0
2063634,2,1,4,4,0,0,0,0
2066145,1,1,3,2,1,0,1,1
2068914,1,1,2,4,-2,2,0,0
2071465,1,1,3,3,0,0,0,0
2073108,1,1,2,4,-2,2,0,0
2073281,1,1,7,4,3,0,3,3
2073281,2,1,10,5,5,1,6,6
2077675,1,1,7,6,1,0,1,1
2079867,1,1,8,6,2,0,2,2
2081680,1,1,2,2,0,0,0,0
2081680,2,1,16,13,3,0,3,3
2087983,1,1,4,2,2,0,2,2
2088399,1,1,0,0,0,0,0,0
2088399,2,1,0,0,0,0,0,0
2090541,1,1,0,0,0,0,0,0
2091861,1,1,7,5,2,0,2,2
2091922,1,1,3,2,1,0,1,1
2091922,2,1,0,0,0,0,0,0
2092344,1,1,7,6,1,0,1,0
2092344,2,1,5,5,0,1,1,1
2093995,1,1,9,10,-1,2,1,1
2093995,2,1,6,6,0,0,0,0
2096433,2,1,0,0,0,0,0,0
2100138,1,1,0,0,0,0,0,0
2100138,2,1,0,0,0,0,0,0
2100316,1,1,3,2,1,0,1,1
2100316,2,1,0,0,0,0,0,0
2100969,1,1,14,5,9,0,9,9
2100969,2,1,0,0,0,0,0,0
2101784,1,1,0,0,0,0,0,0
2101784,2,1,9,7,2,0,2,2
2102529,1,1,3,3,0,0,0,0
2105519,1,1,3,3,0,0,0,0
2107058,1,1,0,0,0,0,0,0
2107632,1,1,11,10,1,0,1,1
2107632,2,1,0,0,0,0,0,0
2110655,1,1,5,5,0,0,0,0
2110655,2,1,5,5,0,0,0,0
2112210,1,1,20,17,3,2,5,4
2112545,1,1,0,0,0,0,0,0
2114417,1,1,10,6,4,0,4,3
2114417,2,1,10,8,2,0,2,2
2115512,1,1,4,3,1,1,1,1
2116055,1,1,2,2,0,0,0,0
2117118,1,1,4,4,0,0,0,0
2117118,2,1,0,0,0,0,0,0
2118599,1,1,6,6,0,1,1,0
2118599,2,1,0,0,0,0,0,0
2118599,3,1,0,0,0,0,0,0
2118969,1,1,9,6,3,0,3,3
2124243,1,1,3,3,0,0,0,0
2124243,2,1,8,8,0,0,0,0
2124243,3,1,0,0,0,0,0,0
2126951,1,1,6,2,4,0,4,4
2126951,2,1,3,3,0,0,0,0
2126951,3,1,5,2,3,0,3,3
2127541,1,1,0,0,0,0,0,0
2129795,1,1,14,9,5,2,7,0
2133833,1,1,2,2,0,0,0,0
2133996,2,1,0,0,0,0,0,0
2134106,1,1,5,5,0,0,0,0
2134743,1,1,0,0,0,0,0,0
2135008,1,1,6,2,4,0,4,4
2135596,1,1,4,2,2,0,2,2
2138481,1,1,0,0,0,0,0,0
2138481,2,1,0,0,0,0,0,0
2139136,1,1,3,4,-1,2,1,1
2142614,1,1,5,5,0,0,0,0
2143765,1,1,7,6,1,0,1,1
2143765,2,1,0,0,0,0,0,0
2145157,1,1,3,3,0,0,0,0
2145157,2,1,0,0,0,0,0,0
2145281,1,1,0,0,0,0,0,0
2145833,1,1,7,3,4,0,4,3
2145833,2,1,4,1,3,0,3,3
2145833,3,1,2,2,0,0,0,0
2148249,1,1,7,7,0,0,0,0
2148249,2,1,4,2,2,0,2,1
2150238,1,1,2,7,-5,5,0,0
2150436,1,1,4,4,0,0,0,0
2150491,1,1,0,0,0,0,0,0
2151470,1,1,0,0,0,0,0,0
2151885,1,1,6,4,2,0,2,2
2152180,1,1,10,9,1,0,1,1
2152180,2,1,0,0,0,0,0,0
2152670,2,1,1,2,-1,1,0,0
2153233,1,1,0,0,0,0,0,0
2153233,2,1,3,2,1,0,1,0
2153233,3,1,2,2,0,0,0,0
2153929,1,1,10,11,-1,1,0,0
2161801,1,1,5,2,3,0,3,3
2161830,1,1,5,5,0,0,0,0
2161830,2,1,3,3,0,0,0,0
2162726,1,1,0,0,0,0,0,0
2162726,2,1,0,0,0,0,0,0
2163039,1,1,19,12,7,0,7,7
2163277,1,1,8,4,4,0,4,4
2164342,1,1,2,2,0,0,0,0
2164342,2,1,5,5,0,0,0,0
2164553,1,1,15,13,2,0,2,1
2164553,2,1,0,0,0,0,0,0
2165061,2,1,5,5,0,0,0,0
2168290,1,1,0,0,0,0,0,0
2168290,2,1,10,7,3,0,3,2
2170054,1,1,5,4,1,0,1,1
2170054,2,1,0,0,0,0,0,0
2171840,1,1,3,5,-2,2,0,0
2172832,1,1,5,5,0,0,0,0
2173340,1,1,5,3,2,0,2,2
2174025,1,1,3,3,0,0,0,0
2176859,1,1,3,3,0,0,0,0
2176859,2,1,8,8,0,0,0,0
2177162,1,1,6,5,1,0,1,1
2177162,2,1,2,2,0,0,0,0
2181379,1,1,0,0,0,0,0,0
2182179,1,1,8,8,0,0,0,0
2182179,2,1,3,3,0,0,0,0
2182208,1,1,6,6,0,0,0,0
2182208,2,1,0,0,0,0,0,0
2182487,1,1,5,5,0,0,0,0
2182487,2,1,3,3,0,0,0,0
2182897,1,1,4,3,1,0,1,1
2182897,2,1,4,4,0,0,0,0
2182897,3,1,0,0,0,0,0,0
2184681,1,1,0,0,0,0,0,0
2184681,2,1,0,0,0,0,0,0
2185910,1,1,6,2,4,0,4,4
2185910,2,1,0,0,0,0,0,0
2188225,2,1,10,9,1,0,1,1
2189776,1,1,0,0,0,0,0,0
2189776,2,1,0,0,0,0,0,0
2190304,1,1,6,3,3,0,3,3
2190583,1,1,5,5,0,0,0,0
2191101,1,1,0,0,0,0,0,0
2191101,2,1,2,2,0,0,0,0
2191101,3,1,2,2,0,0,0,0
2191257,1,1,6,6,0,0,0,0
2191257,2,1,6,5,1,0,1,1
2192624,1,1,2,2,0,0,0,0
2192624,2,1,2,2,0,0,0,0
2192852,1,1,3,3,0,0,0,0
2193112,1,1,4,4,0,0,0,0
2193177,1,1,2,3,-1,1,0,0
2193477,1,1,5,8,-3,3,0,0
2193477,2,1,2,2,0,0,0,0
2194651,1,1,4,4,0,0,0,0
2195426,3,1,3,3,0,0,0,0
2195860,1,1,5,5,0,0,0,0
2195860,2,1,2,2,0,0,0,0
2196088,1,1,4,3,1,0,1,1
2196088,2,1,2,2,0,0,0,0
2196259,1,1,0,0,0,0,0,0
2196259,2,1,0,0,0,0,0,0
2198528,2,1,9,9,0,0,0,0
2198964,1,1,0,0,0,0,0,0
2199292,1,1,3,3,0,0,0,0
2199292,2,1,5,5,0,0,0,0
2199915,1,1,3,2,1,0,1,1
2200081,1,1,5,3,2,0,2,2
2200182,2,1,5,5,0,0,0,0
2200369,1,1,5,5,0,0,0,0
2200507,1,1,7,6,1,0,1,1
2200507,2,1,0,0,0,0,0,0
2200523,1,1,2,2,0,0,0,0
2200523,2,1,0,0,0,0,0,0
2201352,1,1,4,4,0,0,0,0
2201366,1,1,2,2,0,0,0,0
2203711,1,1,6,5,1,0,1,1
2204676,1,1,2,2,0,0,0,0
2204676,2,1,3,3,0,0,0,0
2205328,1,1,6,5,1,0,1,0
2209301,1,1,13,13,0,0,0,0
2209459,1,1,0,0,0,0,0,0
2209459,3,1,0,0,0,0,0,0
2210517,1,1,0,0,0,0,0,0
2210517,2,1,12,12,0,0,0,0
2217784,1,1,2,2,0,0,0,0
2219826,1,1,8,5,3,0,3,3
2219826,2,1,0,0,0,0,0,0
2221407,1,1,9,2,7,0,7,2
2222818,1,1,0,0,0,0,0,0
2228452,1,1,3,3,0,0,0,0
2232422,1,1,0,0,0,0,0,0
2235082,1,1,3,3,0,0,0,0
2235082,2,1,2,2,0,0,0,0
2239822,1,1,3,3,0,0,0,0
2240620,1,1,4,4,0,0,0,0
2240620,2,1,2,2,0,0,0,0
2241612,1,1,3,3,0,0,0,0
2241612,2,1,3,3,0,0,0,0
2242167,1,1,0,0,0,0,0,0
2242167,2,1,0,0,0,0,0,0
2245911,1,1,5,5,0,0,0,0
2245911,2,1,5,4,1,0,1,0
2245911,3,1,0,0,0,0,0,0
2246720,1,1,7,6,1,0,1,1
2248059,1,1,5,4,1,0,1,1
2249023,1,1,0,0,0,0,0,0
2249261,2,1,2,1,1,0,1,0
2251495,1,1,9,7,2,0,2,2
2264250,1,1,5,5,0,0,0,0
2264250,2,1,1,1,0,0,0,0
2265062,1,1,3,3,0,0,0,0
2265657,1,1,3,3,0,0,0,0
2268883,1,1,0,0,0,0,0,0
2269818,1,1,8,8,0,0,0,0
2269818,2,1,0,0,0,0,0,0
2269818,3,1,0,0,0,0,0,0
2270415,1,1,0,0,0,0,0,0
2272289,1,1,14,14,0,0,0,0
2272566,1,1,0,0,0,0,0,0
2273559,1,1,5,4,1,0,1,1
2273559,2,1,0,0,0,0,0,0
2273634,1,1,0,0,0,0,0,0
2273634,2,1,7,6,1,0,1,1
2276211,1,1,4,4,0,0,0,0
2276519,1,1,3,2,1,0,1,0
2276519,2,1,17,16,1,0,1,1
2277111,1,1,15,3,12,0,12,12
2277111,2,1,3,3,0,0,0,0
2277181,1,1,10,6,4,0,4,4
2277181,2,1,0,0,0,0,0,0
2277181,3,1,2,2,0,0,0,0
2277265,1,1,7,7,0,0,0,0
2278285,1,1,0,0,0,0,0,0
2278285,2,1,5,4,1,0,1,1
2281839,1,1,6,5,1,0,1,1
2281839,2,1,3,3,0,0,0,0
2281839,3,1,9,6,3,0,3,3
2282058,1,1,9,5,4,0,4,4
2282058,2,1,3,5,-2,2,0,0
2282123,1,1,7,7,0,0,0,0
2282474,1,1,0,0,0,0,0,0
2283181,1,1,0,0,0,0,0,0
2283993,1,1,3,2,1,0,1,1
2283993,2,1,6,3,3,0,3,3
2283993,3,1,2,2,0,0,0,0
2284036,2,1,5,5,0,0,0,0
2287073,1,1,2,2,0,0,0,0
2287073,2,1,0,0,0,0,0,0
2287073,3,1,0,0,0,0,0,0
2289030,1,1,2,2,0,0,0,0
2289030,2,1,9,8,1,0,1,1
2291177,1,1,5,5,0,0,0,0
2291177,2,1,3,3,0,0,0,0
2291707,1,1,8,8,0,0,0,0
2293092,1,1,6,4,2,0,2,2
2293092,2,1,0,0,0,0,0,0
2293347,1,1,0,0,0,0,0,0
2293347,2,1,0,0,0,0,0,0
2293347,3,1,0,0,0,0,0,0
2293619,1,1,7,7,0,0,0,0
2293619,2,1,0,0,0,0,0,0
2293619,3,1,0,0,0,0,0,0
2295191,1,1,4,2,2,0,2,2
2295191,2,1,5,4,1,0,1,1
2296514,1,1,0,0,0,0,0,0
2296514,2,1,2,2,0,0,0,0
2296983,1,1,4,5,-1,3,2,2
2297178,1,1,5,5,0,0,0,0
2297178,2,1,0,0,0,0,0,0
2297229,1,1,0,0,0,0,0,0
2297229,2,1,0,0,0,0,0,0
2297751,1,1,0,0,0,0,0,0
2297751,2,1,8,5,3,0,3,3
2297751,3,1,9,2,7,0,7,7
2298712,1,1,3,2,1,0,1,1
2298712,2,1,0,0,0,0,0,0
2298712,3,1,0,0,0,0,0,0
2298950,1,1,3,3,0,0,0,0
2298950,2,1,0,0,0,0,0,0
2299296,1,1,8,8,0,0,0,0
2299296,3,1,0,0,0,0,0,0
2299296,4,1,4,4,0,0,0,0
2300641,1,1,9,9,0,0,0,0
2300641,2,1,2,2,0,0,0,0
2300892,2,1,0,0,0,0,0,0
2301949,1,1,0,0,0,0,0,0
2301949,2,1,8,8,0,0,0,0
2302136,1,1,6,5,1,0,1,1
2302136,2,1,0,0,0,0,0,0
2302136,3,1,0,0,0,0,0,0
2302173,1,1,3,3,0,0,0,0
2302173,2,1,4,4,0,0,0,0
2302867,1,1,4,4,0,0,0,0
2302867,2,1,5,4,1,0,1,1
2302867,3,1,4,2,2,0,2,2
2303272,1,1,10,9,1,1,2,2
2303932,1,1,7,5,2,0,2,2
2303932,2,1,3,3,0,0,0,0
2303938,1,1,2,2,0,0,0,0
2303938,2,1,0,0,0,0,0,0
2303938,4,1,0,0,0,0,0,0
2304005,1,1,7,4,3,0,3,3
2304005,2,1,3,3,0,0,0,0
2304913,1,1,4,3,1,0,1,1
2304962,1,1,4,4,0,0,0,0
2304962,2,1,2,2,0,0,0,0
2305104,1,1,2,4,-2,2,0,0
2305104,2,1,5,5,0,0,0,0
2305104,3,1,0,0,0,0,0,0
2305547,1,1,4,3,1,0,1,0
2305547,2,1,6,6,0,0,0,0
2305705,1,1,7,2,5,0,5,5
2305705,2,1,5,5,0,0,0,0
2305846,1,1,5,5,0,0,0,0
2305846,2,1,2,2,0,0,0,0
2305940,1,1,2,2,0,0,0,0
2306291,1,1,3,3,0,0,0,0
2307504,1,1,6,5,1,0,1,0
2307504,2,1,2,2,0,0,0,0
2307504,3,1,4,3,1,0,1,1
2307881,1,1,3,3,0,0,0,0
2307881,2,1,2,2,0,0,0,0
2307890,1,1,2,2,0,0,0,0
2307890,2,1,0,0,0,0,0,0
2310311,1,1,6,6,0,0,0,0
2310311,2,1,6,6,0,1,1,1
2310316,1,1,0,0,0,0,0,0
2310316,2,1,0,0,0,0,0,0
2310316,3,1,0,0,0,0,0,0
2310452,1,1,7,2,5,0,5,5
2310501,1,1,6,6,0,0,0,0
2310501,2,1,0,0,0,0,0,0
2310501,3,1,0,0,0,0,0,0
2310789,1,1,7,6,1,0,1,1
2310789,2,1,6,4,2,0,2,2
2310789,3,1,4,4,0,0,0,0
2311171,2,1,0,0,0,0,0,0
2311171,3,1,0,0,0,0,0,0
2311280,1,1,3,3,0,0,0,0
2311280,2,1,5,5,0,0,0,0
2311280,3,1,0,0,0,0,0,0
2312265,1,1,0,0,0,0,0,0
2312265,2,1,0,0,0,0,0,0
2312406,1,1,2,2,0,0,0,0
2312406,2,1,4,4,0,0,0,0
2312406,3,1,3,5,-2,2,0,0
2312744,1,1,3,3,0,0,0,0
2312796,1,1,0,0,0,0,0,0
2312796,2,1,0,0,0,0,0,0
2312959,1,1,0,0,0,0,0,0
2312959,2,1,2,4,-2,2,0,0
2316221,1,1,3,2,1,0,1,1
2316221,2,1,8,8,0,0,0,0
2316387,2,1,0,0,0,0,0,0
2316387,3,1,2,2,0,0,0,0
2316693,1,1,10,6,4,0,4,3
2316693,2,1,10,10,0,2,2,2
2316693,3,1,3,3,0,0,0,0
2316804,1,1,3,3,0,0,0,0
2316804,2,1,5,3,2,0,2,2
2317277,1,1,4,4,0,0,1,1
2317277,2,1,2,2,0,0,0,0
2317579,1,1,7,9,-2,2,0,0
2317579,3,1,2,2,0,0,0,0
2317960,2,1,13,10,3,0,3,2
2317960,3,1,6,4,2,1,3,3
2318278,1,1,2,2,0,0,0,0
2318278,4,1,0,0,0,0,0,0
2318367,1,1,0,0,0,0,0,0
2318367,2,1,5,3,2,0,2,2
2318457,1,1,2,2,0,0,0,0
2318457,2,1,3,3,0,0,0,0
2321153,1,1,7,7,0,0,0,0
2323273,1,1,4,4,0,0,0,0
2323273,2,1,3,2,1,0,1,1
2324776,1,1,3,3,0,0,0,0
2324776,2,1,3,2,1,0,1,1
2325206,1,1,4,4,0,0,0,0
2325206,2,1,3,3,0,0,0,0
2325661,1,1,0,0,0,0,0,0
2325779,1,1,0,0,0,0,0,0
2325779,2,1,2,4,-2,2,0,0
2325779,3,1,3,4,-1,1,0,0
2326193,2,1,9,9,0,0,0,0
2326280,1,1,6,6,0,0,0,0
2326280,2,1,4,4,0,0,0,0
2326873,1,1,2,2,0,0,0,0
2326873,2,1,9,9,0,0,0,0
2326929,1,1,4,4,0,0,0,0
2326929,2,1,0,0,0,0,0,0
2326929,3,1,0,0,0,0,0,0
2327315,1,1,10,6,4,0,4,4
2327315,2,1,5,4,1,0,1,1
2327315,3,1,8,8,0,0,0,0
2327645,1,1,2,2,0,0,0,0
2327834,1,1,5,5,0,0,0,0
2327917,1,1,0,0,0,0,0,0
2327917,2,1,5,2,3,0,3,3
2328079,1,1,3,3,0,0,0,0
2328254,1,1,8,8,0,0,0,0
2328416,1,1,0,0,0,0,0,0
2328440,1,1,7,7,0,0,0,0
2328988,1,1,5,5,0,0,0,0
2328988,2,1,0,0,0,0,0,0
2329142,1,1,4,4,0,0,0,0
2329142,2,1,2,2,0,0,0,0
2329526,1,1,5,5,0,0,0,0
2329948,2,1,0,0,0,0,0,0
2331443,1,1,0,0,0,0,0,0
2331443,2,1,0,0,0,0,0,0
2332725,2,1,15,2,13,0,13,12
2332779,1,1,5,5,0,0,0,0
2332779,2,1,7,6,1,1,2,2
2332917,1,1,15,2,13,0,13,10
2332917,2,1,4,4,0,0,0,0
2333858,1,1,8,8,0,0,0,0
2333858,2,1,0,0,0,0,0,0
2334262,1,1,9,9,0,0,0,0
2334262,2,1,3,2,1,0,1,1
2334744,1,1,2,2,0,0,0,0
2334744,2,1,2,2,0,0,0,0
2334744,3,1,3,2,1,0,1,1
2335056,1,1,0,0,0,0,0,0
2335056,2,1,0,0,0,0,0,0
2336260,1,1,4,4,0,0,0,0
2336260,2,1,0,0,0,0,0,0
2336373,2,1,2,2,0,0,0,0
2337676,1,1,4,3,1,0,1,1
2337815,1,1,0,0,0,0,0,0
2337815,3,1,5,5,0,0,0,0
2337959,1,1,6,7,-1,1,0,0
2337959,2,1,4,4,0,0,0,0
2337959,3,1,6,4,2,0,2,2
2338147,1,1,5,5,0,0,0,0
2338147,2,1,2,2,0,0,0,0
2338810,2,1,3,4,-1,1,0,0
2338810,3,1,8,8,0,1,1,0
2339902,1,1,13,11,2,0,2,2
2341168,1,1,7,6,1,0,1,1
2342318,1,1,7,7,0,0,0,0
2342318,2,1,5,4,1,0,1,1
2342318,3,1,2,2,0,0,0,0
2342957,1,1,4,2,2,0,2,2
2342957,2,1,9,8,1,0,1,1
2343146,1,1,9,8,1,0,1,1
2343146,2,1,9,9,0,0,0,0
2345470,1,1,3,3,0,0,0,0
2345470,2,1,9,7,2,0,2,0
2345822,1,1,6,9,-3,4,1,1
2345822,2,1,8,7,1,0,1,1
2347476,1,1,4,4,0,0,0,0
2347476,2,1,3,3,0,0,0,0
2347526,1,1,14,12,2,0,2,2
2347573,1,1,7,6,1,0,1,0
2347573,2,1,9,6,3,1,4,3
2347770,1,1,5,5,0,0,0,0
2347770,2,1,0,0,0,0,0,0
2349312,1,1,4,4,0,0,0,0
2349312,2,1,2,2,0,0,0,0
2349649,1,1,2,2,0,0,0,0
2349649,2,1,0,0,0,0,0,0
2349781,1,1,7,7,0,0,0,0
2349781,2,1,6,7,-1,1,0,0
2350567,1,1,2,2,0,0,0,0
2350567,2,1,0,0,0,0,0,0
2350567,3,1,2,2,0,0,0,0
2350791,1,1,4,2,2,0,2,0
2350791,2,1,0,0,0,0,0,0
2351673,1,1,13,13,0,0,0,0
2351941,1,1,8,8,0,0,0,0
2351941,2,1,5,5,0,0,0,0
2352441,1,1,5,4,1,0,1,1
2352441,2,1,8,8,0,0,0,0
2352441,3,1,0,0,0,0,0,0
2352460,1,1,12,9,3,0,3,3
2352830,1,1,3,3,0,0,0,0
2352830,2,1,2,2,0,0,0,0
2353102,2,1,10,4,6,0,6,4
2353102,3,1,3,3,0,0,0,0
2353819,3,1,0,0,0,0,0,0
2354512,1,1,0,0,0,0,0,0
2354512,2,1,8,7,1,0,1,1
2354538,1,1,2,2,0,0,0,0
2354538,2,1,3,3,0,0,0,0
2354856,1,1,3,5,-2,2,0,0
2354856,2,1,0,0,0,0,0,0
2355100,1,1,4,5,-1,1,0,0
2355100,2,1,7,8,-1,2,1,1
2355421,1,1,4,4,0,0,0,0
2355598,1,1,3,3,0,0,0,0
2355598,2,1,2,2,0,0,0,0
2356596,1,1,5,5,0,0,0,0
2357075,1,1,1,2,-1,1,0,0
2357075,2,1,7,7,0,0,0,0
2357169,1,1,2,2,0,0,0,0
2357169,2,1,6,6,0,0,0,0
2358372,1,1,4,2,2,0,2,2
2358372,2,1,0,0,0,0,0,0
2360035,1,1,8,5,3,0,3,1
2360035,2,1,7,7,0,0,0,0
2360537,1,1,2,2,0,0,0,0
2360537,2,1,3,5,-2,2,0,0
2360537,3,1,11,9,2,0,2,2
2360901,1,1,0,0,0,0,0,0
2360901,2,1,3,3,0,0,0,0
2360901,3,1,3,3,0,0,0,0
2362468,1,1,2,2,0,0,0,0
2362468,2,1,0,0,0,0,0,0
2362468,3,1,13,9,4,0,4,4
2363249,1,1,0,0,0,0,0,0
2363249,2,1,3,3,0,0,0,0
2364473,2,1,3,2,1,0,1,0
2364520,1,1,8,5,3,0,3,3
2364520,2,1,0,0,0,0,0,0
2365976,1,1,0,0,0,0,0,0
2366906,2,1,0,0,0,0,0,0
2366906,3,1,2,2,0,0,0,0
2368231,1,1,6,7,-1,1,0,0
2368231,2,1,4,4,0,0,0,0
2368565,1,1,15,14,1,0,1,0
2368565,2,1,2,2,0,0,0,0
2368582,1,1,11,9,2,0,2,2
2368582,2,1,2,2,0,0,0,0
2369107,1,1,0,0,0,0,0,0
2369107,2,1,1,3,-2,2,0,0
2370506,1,1,8,8,0,0,0,0
2370506,2,1,8,8,0,0,0,0
2371922,1,1,2,2,0,0,0,0
2371922,2,1,2,2,0,0,0,0
2372115,1,1,6,6,0,0,0,0
2372115,2,1,10,10,0,0,0,0
2372115,3,1,0,0,0,0,0,0
2372425,1,1,7,7,0,0,0,0
2372525,1,1,0,0,0,0,0,0
2373556,1,1,0,0,0,0,0,0
2373572,1,1,8,5,3,0,3,2
2373572,2,1,0,0,0,0,0,0
2376371,1,1,4,4,0,0,0,0
2378081,2,1,0,0,0,0,0,0
2378081,3,1,0,0,0,0,0,0
2378577,1,1,8,7,1,0,1,1
2378577,2,1,0,0,0,0,0,0
2379630,1,1,8,6,2,0,2,1
2379630,2,1,3,2,1,0,1,1
2379630,3,1,6,1,5,0,5,5
2379717,1,1,3,3,0,0,0,0
2379717,2,1,6,7,-1,1,0,0
2379932,1,1,4,4,0,0,0,0
2379932,2,1,9,8,1,0,1,0
2380497,1,1,4,4,0,0,0,0
2380497,3,1,8,6,2,0,2,1
2381038,1,1,5,3,2,0,2,2
2381038,2,1,5,2,3,0,3,3
2382321,1,1,2,2,0,0,0,0
2382321,2,1,2,2,0,0,0,0
2382455,1,1,0,0,0,0,0,0
2382455,2,1,5,5,0,0,0,0
2382840,1,1,7,6,1,0,1,1
2382840,2,1,0,0,0,0,0,0
2383129,1,1,7,8,-1,1,0,0
2383129,2,1,8,7,1,0,1,1
2383129,3,1,0,0,0,0,0,0
2383147,1,1,0,0,0,0,0,0
2383147,2,1,0,0,0,0,0,0
2383662,1,1,4,4,0,0,0,0
2383662,2,1,10,9,1,0,1,1
2384366,3,1,6,3,3,0,3,2
2384816,1,1,7,7,0,0,0,0
2384816,2,1,0,0,0,0,0,0
2384816,3,1,0,0,0,0,0,0
2384894,1,1,8,4,4,0,4,4
2386558,1,1,5,1,4,0,4,4
2387832,1,1,3,3,0,0,0,0
2387832,2,1,3,2,1,0,1,1
2388313,1,1,0,0,0,0,0,0
2388754,1,1,3,4,-1,1,0,0
2388754,2,1,2,2,0,0,0,0
2388915,1,1,2,3,-1,1,0,0
2388915,2,1,8,6,2,0,2,2
2389478,1,1,0,0,0,0,0,0
2389902,1,1,5,3,2,0,2,2
2389902,2,1,4,4,0,0,0,0
2390246,1,1,2,2,0,0,0,0
2390246,2,1,4,4,0,0,0,0
2390614,1,1,0,0,0,0,0,0
2390614,2,1,3,3,0,1,1,1
2390614,3,1,8,8,0,0,0,0
2390624,1,1,10,10,0,0,0,0
2390624,2,1,5,3,2,1,0,0
2390963,1,1,4,4,0,0,0,0
2390963,2,1,4,4,0,0,0,0
2391858,1,1,0,0,0,0,0,0
2391858,2,1,4,5,-1,1,0,0
2394171,1,1,6,10,-4,5,1,1
2394171,2,1,5,5,0,3,3,3
2394746,1,1,2,6,-4,4,0,0
2394881,1,1,6,2,4,0,4,3
2394881,2,1,7,6,1,0,1,0
2395797,1,1,3,2,1,0,1,1
2395961,1,1,5,5,0,0,0,0
2395961,2,1,3,3,0,0,0,0
2396113,1,1,7,10,-3,3,0,0
2396113,2,1,6,4,2,0,2,1
2396113,3,1,3,2,1,0,1,1
2398402,1,1,5,5,0,0,0,0
2398422,1,1,4,2,2,0,2,2
2398422,2,1,0,0,0,0,0,0
2398459,1,1,5,4,1,0,1,0
2398459,2,1,5,6,-1,1,0,0
2398754,1,1,0,0,0,0,0,0
2398754,2,1,0,0,0,0,0,0
2398890,4,1,0,0,0,0,0,0
2398890,5,1,0,0,0,0,0,0
2398890,6,1,8,7,1,0,1,1
2399709,1,1,0,0,0,0,0,0
2399709,2,1,0,0,0,0,0,0
2400214,1,1,3,2,1,0,1,0
2400472,1,1,6,5,1,0,1,0
2401113,3,1,0,0,0,0,0,0
2401906,1,1,3,3,0,0,0,0
2401906,2,1,3,3,0,0,0,0
2401906,3,1,2,2,0,0,0,0
2401943,1,1,2,4,-2,2,0,0
2401943,2,1,4,4,0,0,0,0
2403771,1,1,1,2,-1,1,0,0
2404239,1,1,9,7,2,1,3,0
2404239,2,1,4,6,-2,2,0,0
2404351,1,1,3,3,0,0,0,0
2404351,2,1,0,0,0,0,0,0
2405722,1,1,12,12,0,0,0,0
2405722,2,1,5,5,0,0,0,0
2407871,1,1,6,6,0,0,0,0
2407871,2,1,0,0,0,0,0,0
2407871,3,1,7,8,-1,1,0,0
2408071,1,1,2,2,0,0,0,0
2408071,2,1,5,4,1,0,1,1
2408404,1,1,6,7,-1,1,0,0
2408404,2,1,4,3,1,0,1,1
2409059,1,1,4,4,0,0,0,0
2409059,2,1,0,0,0,0,0,0
2409548,1,1,0,0,0,0,0,0
2409548,2,1,7,7,0,0,0,0
2410016,1,1,14,14,0,0,0,0
2413418,1,1,9,8,1,0,1,1
2413726,1,1,3,3,0,0,0,0
2414333,2,1,0,0,0,0,0,0
2414419,1,1,0,0,0,0,0,0
2414419,2,1,0,0,0,0,0,0
2414419,3,1,0,0,0,0,0,0
2414480,1,1,8,8,0,0,0,0
2414480,2,1,0,0,0,0,0,0
2415570,1,1,5,4,1,0,1,1
2415570,2,1,0,0,0,0,0,0
2415570,3,1,0,0,0,0,0,0
2415574,1,1,4,4,0,0,0,0
2415574,2,1,4,2,2,0,2,2
2415648,2,1,0,0,0,0,0,0
2415985,1,1,2,2,0,0,0,0
2415985,2,1,0,0,0,0,0,0
2415985,3,1,2,2,0,0,0,0
2416496,1,1,1,2,-1,1,0,0
2416496,2,1,1,0,1,0,1,0
2416496,3,1,0,0,0,0,0,0
2416728,1,1,1,5,-4,4,0,0
2416728,2,1,0,0,0,0,0,0
2417034,1,1,5,5,0,0,0,0
2417034,2,1,0,0,0,0,0,0
2417281,1,1,0,0,0,0,0,0
2417281,2,1,0,0,0,0,0,0
2417842,1,1,15,15,0,1,1,1
2417842,2,1,4,4,0,2,2,2
2418104,1,1,4,4,0,0,0,0
2418104,2,1,5,2,3,0,3,3
2418115,1,1,3,2,1,0,1,1
2418115,2,1,0,0,0,0,0,0
2418115,3,1,0,0,0,0,0,0
2418490,1,1,6,6,0,0,0,0
2418490,2,1,0,0,0,0,0,0
2419119,1,1,7,6,1,0,1,1
2419119,2,1,5,5,0,0,0,0
2419241,1,1,1,1,0,0,0,0
2419241,2,1,13,11,2,0,2,1
2419241,3,1,0,0,0,0,0,0
2419783,1,1,0,0,0,0,0,0
2419783,2,1,0,0,0,0,0,0
2419783,3,1,0,0,0,0,0,0
2420048,1,1,5,4,1,0,1,1
2420048,3,1,9,7,2,0,2,1
2420150,1,1,0,0,0,0,0,0
2420150,2,1,2,2,0,0,0,0
2420150,3,1,4,4,0,0,0,0
2420299,1,1,9,9,0,0,0,0
2422028,1,1,7,5,2,0,2,2
2422428,1,1,1,5,-4,4,0,0
2422428,2,1,0,0,0,0,0,0
2424525,1,1,9,8,1,0,1,1
2424525,2,1,2,2,0,0,0,0
2424997,1,1,4,4,0,0,0,0
2424997,2,1,18,18,0,3,3,1
2425211,1,1,6,5,1,0,1,1
2425211,2,1,2,2,0,0,0,0
2425287,1,1,0,0,0,0,0,0
2425287,2,1,5,4,1,0,1,1
2426057,1,1,6,5,1,0,1,1
2426057,2,1,2,2,0,0,0,0
2426368,1,1,3,3,0,0,0,0
2426368,2,1,0,0,0,0,0,0
2427067,1,1,7,7,0,0,0,0
2427067,2,1,0,0,0,0,0,0
2427682,1,1,0,0,0,0,0,0
2427682,2,1,3,5,-2,3,1,1
2428278,1,1,0,0,0,0,0,0
2428278,2,1,8,8,0,0,0,0
2429616,1,1,0,0,0,0,0,0
2429616,2,1,2,2,0,0,0,0
2430861,1,1,3,2,1,0,1,1
2430861,2,1,3,3,0,0,0,0
2432578,1,1,2,0,2,0,2,0
2432578,2,1,0,0,0,0,0,0
2432637,1,1,2,2,0,0,0,0
2432637,2,1,0,0,0,0,0,0
2432740,1,1,2,2,0,0,0,0
2432740,2,1,9,10,-1,2,1,1
2433024,1,1,7,6,1,0,1,1
2433024,2,1,4,4,0,0,0,0
2433235,1,1,6,6,0,0,0,0
2433235,2,1,5,5,0,0,0,0
2433235,3,1,2,2,0,0,0,0
2433269,2,1,3,4,-1,1,0,0
2433399,1,1,4,4,0,1,1,1
2433399,2,1,0,0,0,0,0,0
2433431,1,1,4,4,0,0,0,0
2433431,2,1,12,6,6,0,6,6
2433574,1,1,6,6,0,0,0,0
2433574,2,1,7,6,1,0,1,1
2433715,1,1,4,4,0,0,0,0
2433715,2,1,7,6,1,0,1,1
2434082,2,1,5,5,0,0,0,0
2434082,3,1,4,4,0,0,0,0
2434230,1,1,11,6,5,2,7,7
2434230,2,1,6,2,4,0,4,4
2434616,1,1,6,6,0,0,0,0
2434616,2,1,7,6,1,0,1,1
2434663,1,1,7,5,2,0,2,2
2434663,2,1,0,0,0,0,0,0
2434804,1,1,12,12,0,0,0,0
2434804,2,1,2,2,0,0,0,0
2435301,2,1,4,4,0,0,0,0
2435570,1,1,0,0,0,0,0,0
2435570,2,1,8,6,2,0,2,2
2436742,1,1,7,2,5,0,5,5
2436742,2,1,3,3,0,0,0,0
2436985,1,1,5,5,0,0,0,0
2436985,2,1,0,0,0,0,0,0
2437182,1,1,0,0,0,0,0,0
2437182,3,1,0,0,0,0,0,0
2437669,1,1,0,0,0,0,0,0
2437669,2,1,0,0,0,0,0,0
2437948,1,1,0,0,0,0,0,0
2437948,2,1,5,5,0,0,0,0
2438280,1,1,0,0,0,0,0,0
2438280,2,1,0,0,0,0,0,0
2438308,1,1,13,9,4,0,4,4
2438978,1,1,16,12,4,0,4,3
2438978,2,1,3,3,0,0,0,0
2438978,3,1,0,0,0,0,0,0
2439539,1,1,7,6,1,0,1,1
2439539,2,1,0,0,0,0,0,0
2439649,1,1,5,4,1,0,1,1
2439649,2,1,5,5,0,0,0,0
2439746,1,1,9,8,1,0,1,1
2439746,2,1,0,0,0,0,0,0
2440841,2,1,0,0,0,0,0,0
2443184,1,1,0,0,0,0,0,0
2443184,2,1,0,0,0,0,0,0
2443184,3,1,0,0,0,0,0,0
2443193,2,1,3,2,1,0,1,1
2443833,1,1,6,5,1,0,1,1
2443911,1,1,8,7,1,0,1,1
2443911,2,1,8,8,0,0,0,0
2444003,1,1,16,6,10,0,10,10
2444003,2,1,0,0,0,0,0,0
2444222,1,1,5,5,0,0,0,0
2444222,2,1,0,0,0,0,0,0
2444222,3,1,3,2,1,0,1,0
2444421,1,1,3,3,0,0,0,0
2444421,2,1,6,5,1,0,1,1
2444676,1,1,2,2,0,0,0,0
2444676,2,1,10,9,1,0,1,1
2444715,1,1,2,2,0,0,0,0
2444715,2,1,0,0,0,0,0,0
2444916,1,1,11,9,2,0,2,2
2447376,1,1,8,9,-1,1,0,0
2447376,2,1,9,7,2,0,2,2
2449290,1,1,1,15,-14,14,0,0
2449290,2,1,2,2,0,0,0,0
2449297,1,1,7,7,0,0,0,0
2449297,2,1,9,7,2,0,2,2
2449297,3,1,0,0,0,0,0,0
2449518,1,1,2,2,0,0,0,0
2449518,2,1,4,9,-5,5,0,0
2450301,1,1,4,4,0,0,0,0
2451977,1,1,7,4,3,0,3,3
2451977,2,1,2,2,0,0,0,0
2452170,1,1,0,0,0,0,0,0
2452170,2,1,6,3,3,0,3,3
2452170,3,1,0,0,0,0,0,0
2453032,2,1,0,0,0,0,0,0
2453250,1,1,3,3,0,0,0,0
2453250,2,1,5,5,0,0,0,0
2453282,1,1,2,3,-1,1,0,0
2453282,2,1,9,8,1,2,3,3
2453660,1,1,8,7,1,2,3,3
2453660,2,1,0,0,0,0,0,0
2453869,1,1,5,5,0,0,0,0
2453869,2,1,2,2,0,0,0,0
2454289,1,1,10,10,0,2,2,2
2454289,2,1,7,6,1,2,3,3
2454289,3,1,0,0,0,0,0,0
2455012,1,1,7,6,1,0,1,1
2455012,2,1,0,0,0,0,0,0
2455420,1,1,10,8,2,0,2,2
2455420,2,1,0,0,0,0,0,0
2455420,3,1,4,4,0,0,0,0
2456024,1,1,0,0,0,0,0,0
2456024,2,1,0,0,0,0,0,0
2456712,1,1,3,2,1,1,2,2
2456712,2,1,0,0,0,0,0,0
2457602,1,1,8,5,3,0,3,3
2457602,2,1,4,4,0,0,0,0
2457602,3,1,3,3,0,0,0,0
2457841,1,1,0,0,0,0,0,0
2458106,1,1,15,14,1,0,1,1
2458679,1,1,4,4,0,0,0,0
2458679,2,1,7,6,1,0,1,1
2458983,1,1,5,5,0,0,0,0
2459309,2,1,7,6,1,0,1,1
2459547,1,1,6,6,0,0,0,0
2459796,1,1,0,0,0,0,0,0
2459796,2,1,9,6,3,0,3,0
2459927,1,1,0,0,0,0,0,0
2459927,2,1,8,4,4,0,4,4
2459948,1,1,3,3,0,0,0,0
2460068,1,1,8,8,0,0,0,0
2460378,1,1,0,0,0,0,0,0
2460378,2,1,6,1,5,0,5,4
2460600,2,1,11,2,9,0,9,8
2460600,3,1,9,2,7,0,7,7
2460925,1,1,6,6,0,0,0,0
2462115,1,1,3,3,0,0,0,0
2462115,2,1,4,4,0,0,0,0
2462115,3,1,2,2,0,0,0,0
2462549,1,1,7,3,4,0,4,4
2462549,2,1,0,0,0,0,0,0
2463400,1,1,8,8,0,0,0,0
2463400,2,1,0,0,0,0,0,0
2463755,1,1,2,2,0,0,0,0
2463810,1,1,5,4,1,0,1,1
2463810,2,1,0,0,0,0,0,0
2464008,1,1,7,7,0,0,0,0
2464008,2,1,6,6,0,0,0,0
2464008,3,1,2,2,0,0,0,0
2465135,1,1,3,3,0,0,0,0
2465169,1,1,6,6,0,0,0,0
2465169,2,1,2,5,-3,3,0,0
2465227,1,1,2,2,0,0,0,0
2465227,2,1,8,8,0,0,0,0
2465884,1,1,6,6,0,0,0,0
2465884,2,1,3,2,1,0,1,1
2465884,3,1,11,8,3,0,3,3
2465895,1,1,8,7,1,2,3,3
2465895,2,1,6,8,-2,2,0,0
2466283,1,1,12,12,0,0,0,0
2466283,2,1,8,6,2,0,2,2
2466793,2,1,9,5,4,0,4,4
2466883,1,1,0,0,0,0,0,0
2466883,2,1,0,0,0,0,0,0
2467897,1,1,7,6,1,0,1,0
2467971,1,1,0,0,0,0,0,0
2467971,3,1,0,0,0,0,0,0
2468020,1,1,0,0,0,0,0,0
2468020,2,1,0,0,0,0,0,0
2468236,1,1,3,3,0,0,0,0
2468236,2,1,9,11,-2,3,1,1
2468758,1,1,9,8,1,0,1,1
2468764,1,1,0,0,0,0,0,0
2468764,2,1,2,2,0,0,0,0
2469509,1,1,5,3,2,0,2,2
2469509,2,1,9,6,3,0,3,2
2469580,1,1,5,5,0,0,0,0
2469580,2,1,0,0,0,0,0,0
2469580,3,1,0,0,0,0,0,0
2469950,1,1,0,0,0,0,0,0
2469950,2,1,0,0,0,0,0,0
2469950,3,1,3,3,0,0,0,0
2470013,1,1,11,11,0,0,0,0
2470013,2,1,4,4,0,0,0,0
2470340,1,1,2,2,0,0,0,0
2470340,2,1,3,2,1,0,1,1
2470925,1,1,0,0,0,0,0,0
2470925,2,1,0,0,0,0,0,0
2470925,3,1,0,0,0,0,0,0
2471172,1,1,6,6,0,0,0,0
2471172,2,1,8,7,1,0,1,1
2471582,2,1,3,3,0,0,0,0
2472150,1,1,2,2,0,0,0,0
2472150,2,1,14,11,3,0,3,2
2472679,1,1,5,4,1,0,1,1
2472679,2,1,0,0,0,0,0,0
2473892,1,1,2,2,0,0,0,0
2474087,1,1,0,0,0,0,0,0
2474087,2,1,0,0,0,0,0,0
2474409,1,1,0,0,0,0,0,0
2474409,2,1,0,0,0,0,0,0
2474431,1,1,1,2,-1,1,0,0
2474431,2,1,3,3,0,1,1,1
2474790,1,1,5,5,0,0,0,0
2474790,2,1,0,0,0,0,0,0
2474790,3,1,0,0,0,0,0,0
2474824,1,1,3,3,0,0,0,0
2474824,2,1,11,7,4,0,4,4
2474832,1,1,8,5,3,0,3,3
2474906,1,1,0,0,0,0,0,0
2474906,2,1,0,0,0,0,0,0
2475130,1,1,1,6,-5,5,0,0
2475130,2,1,3,3,0,0,0,0
2475277,1,1,2,2,0,0,0,0
2475277,2,1,0,0,0,0,0,0
2475429,1,1,2,2,0,0,0,0
2475429,2,1,2,2,0,0,0,0
2475731,1,1,0,0,0,0,0,0
2475786,1,1,1,8,-7,7,0,0
2475786,2,1,2,2,0,0,0,0
2475810,1,1,7,7,0,0,0,0
2475810,2,1,5,5,0,0,0,0
2475918,1,1,0,0,0,0,0,0
2475918,2,1,9,8,1,0,1,0
2476017,1,1,2,2,0,0,0,0
2476018,1,1,4,5,-1,1,0,0
2476018,2,1,3,3,0,0,0,0
2476018,3,1,4,4,0,0,0,0
2476065,1,1,7,5,2,0,2,2
2476157,1,1,5,4,1,0,1,1
2476176,1,1,7,6,1,0,1,1
2476176,2,1,0,0,0,0,0,0
2476201,1,1,8,7,1,0,1,1
2476201,2,1,0,0,0,0,0,0
2476266,2,1,0,0,0,0,0,0
2476266,3,1,0,0,0,0,0,0
2476291,1,1,2,2,0,0,0,0
2476291,2,1,3,3,0,0,0,0
2476371,1,1,6,3,3,0,3,3
2476371,2,1,11,9,2,0,2,2
2476393,1,1,0,0,0,0,0,0
2476393,2,1,0,0,0,0,0,0
2476545,1,1,2,2,0,0,0,0
2476661,1,1,0,0,0,0,0,0
2476857,1,1,4,4,0,0,0,0
2477001,1,1,4,4,0,0,0,0
2477001,2,1,2,2,0,0,0,0
2477001,3,1,0,0,0,0,0,0
2477402,1,1,2,2,0,0,0,0
2477402,2,1,2,2,0,0,0,0
2477521,1,1,0,0,0,0,0,0
2477521,2,1,0,0,0,0,0,0
2477552,1,1,0,0,0,0,0,0
2477552,2,1,2,7,-5,5,0,0
2477552,3,1,4,4,0,0,0,0
2477822,1,1,0,0,0,0,0,0
2477822,2,1,3,2,1,0,1,1
2478107,1,1,4,4,0,0,0,0
2478107,2,1,5,4,1,1,2,2
2478107,3,1,6,6,0,2,2,2
2478148,1,1,10,9,1,0,1,1
2478148,2,1,11,13,-2,2,0,0
2478148,3,1,4,4,0,0,0,0
2478298,1,1,4,5,-1,1,0,0
2478330,1,1,2,2,0,0,0,0
2478330,2,1,15,13,2,0,2,2
2478343,1,1,0,0,0,0,0,0
2478343,3,1,3,2,1,0,1,1
2478460,1,1,6,5,1,0,1,1
2478460,2,1,9,9,0,0,0,0
2478550,1,1,2,3,-1,1,0,0
2478550,2,1,0,0,0,0,0,0
2478550,3,1,0,0,0,0,0,0
2478607,1,1,3,3,0,1,1,1
2478631,1,1,11,6,5,0,5,5
2478631,2,1,9,9,0,0,0,0
2478686,1,1,0,0,0,0,0,0
2478731,1,1,5,4,1,0,1,1
2478755,1,1,3,3,0,0,0,0
2478755,2,1,0,0,0,0,0,0
2478873,1,1,5,7,-2,2,0,0
2478873,2,1,1,3,-2,2,0,0
2478900,1,1,2,2,0,0,0,0
2478900,2,1,2,2,0,0,0,0
2478900,3,1,2,2,0,0,0,0
2478924,1,1,0,0,0,0,0,0
2478924,2,1,5,5,0,0,0,0
2478924,3,1,0,0,0,0,0,0
2478958,1,1,2,7,-5,5,0,0
2478958,2,1,0,0,0,0,0,0
2479145,1,1,1,2,-1,1,0,0
2479145,2,1,2,2,0,0,0,0
2479199,1,1,0,0,0,0,0,0
2479199,2,1,4,4,0,1,1,1
2479367,1,1,1,1,0,0,0,0
2479367,2,1,2,2,0,0,0,0
2479367,3,1,5,5,0,0,0,0
2479420,1,1,6,5,1,0,1,1
2479420,2,1,0,0,0,0,0,0
2479420,3,1,4,4,0,0,0,0
2479528,1,1,3,2,1,0,1,1
2479547,1,1,5,5,0,0,0,0
2479547,2,1,9,8,1,0,1,1
2479642,1,1,10,9,1,0,1,1
2479642,2,1,0,0,0,0,0,0
2479679,1,1,0,0,0,0,0,0
2479679,2,1,0,0,0,0,0,0
2479681,2,1,5,4,1,0,1,0
2479681,3,1,4,4,0,0,0,0
2479760,1,1,14,9,5,0,5,5
2479760,2,1,7,2,5,0,5,5
2479767,1,1,3,2,1,0,1,1
2479767,2,1,6,4,2,0,2,2
2479904,1,1,5,5,0,0,0,0
2479904,2,1,5,3,2,1,3,3
2479904,3,1,8,8,0,0,0,0
2480022,1,1,5,2,3,0,3,3
2480022,2,1,8,8,0,0,0,0
2480022,3,1,9,5,4,0,4,4
2480196,1,1,5,5,0,0,0,0
2480268,1,1,2,2,0,0,0,0
2480268,3,1,0,0,0,0,0,0
2480450,1,1,4,4,0,0,0,0
2480450,2,1,11,7,4,0,4,4
2480465,1,1,2,2,0,0,0,0
2480465,2,1,2,2,0,0,0,0
2480465,3,1,2,2,0,0,0,0
2480479,1,1,7,4,3,1,4,4
2480479,2,1,0,0,0,0,0,0
2480479,3,1,0,0,0,0,0,0
2480563,1,1,0,0,0,0,0,0
2480563,2,1,0,0,0,0,0,0
2480599,1,1,0,0,0,0,0,0
2480599,2,1,0,0,0,0,0,0
2480599,3,1,2,2,0,0,0,0
2480661,1,1,6,6,0,0,0,0
2480661,2,1,4,4,0,0,0,0
2480668,1,1,5,5,0,0,0,0
2486662,1,1,8,9,-1,1,0,0
2486662,2,1,0,0,0,0,0,0
2486662,3,1,0,0,0,0,0,0
2497369,1,1,0,0,0,0,0,0
2500308,1,1,18,16,2,0,2,2
2500308,2,1,0,0,0,0,0,0
2501952,1,1,6,6,0,0,0,0
2501952,2,1,4,4,0,0,0,0
2503252,1,1,0,0,0,0,0,0
2503252,2,1,0,0,0,0,0,0
2507485,1,1,0,0,0,0,0,0
2507485,2,1,5,5,0,0,0,0
2507780,1,1,13,12,1,0,1,1
2507780,2,1,0,0,0,0,0,0
2513919,1,1,14,4,10,0,10,9
2517375,2,1,4,2,2,0,2,0
2520204,1,1,6,5,1,0,1,1
2520204,2,1,10,7,3,0,3,3
2521267,1,1,0,0,0,0,0,0
2521267,2,1,8,7,1,0,1,1
2521373,1,1,6,6,0,0,0,0
2521373,2,1,5,5,0,0,0,0
2525120,1,1,7,2,5,0,5,5
2525943,1,1,5,2,3,0,3,3
2526509,2,1,4,6,-2,2,0,0
2527388,1,1,8,7,1,0,1,1
2527388,2,1,2,2,0,0,0,0
2527393,1,1,2,2,0,0,0,0
2527393,2,1,8,7,1,0,1,1
2527393,3,1,8,2,6,0,6,5
2533175,2,1,0,0,0,0,0,0
2533177,1,1,8,8,0,0,0,0
2533177,2,1,0,0,0,0,0,0
2533430,1,1,8,6,2,0,2,2
2533430,2,1,17,18,-1,1,0,0
2535235,2,1,3,2,1,0,1,1
2535235,3,1,0,0,0,0,0,0
2535483,1,1,3,2,1,0,1,1
2536174,1,1,1,4,-3,3,0,0
2536174,2,1,0,0,0,0,0,0
2539683,1,1,0,0,0,0,0,0
2539683,2,1,0,0,0,0,0,0
2539683,3,1,2,2,0,0,0,0
2539759,1,1,7,7,0,0,0,0
2539759,2,1,2,2,0,0,0,0
2543174,1,1,6,7,-1,1,0,0
2543174,2,1,2,2,0,0,0,0
2543364,1,1,2,4,-2,3,1,1
2543576,1,1,0,0,0,0,0,0
2543576,2,1,3,3,0,0,0,0
2543636,1,1,3,4,-1,1,0,0
2543636,2,1,4,6,-2,2,0,0
2544182,1,1,3,3,0,0,0,0
2544182,2,1,5,5,0,0,0,0
2544245,1,1,24,17,7,0,7,7
2544245,2,1,5,2,3,0,3,3
2544245,3,1,0,0,0,0,0,0
2546298,1,1,0,0,0,0,0,0
2546298,2,1,7,4,3,0,3,3
2547090,1,1,5,2,3,0,3,2
2547090,2,1,0,0,0,0,0,0
2548232,1,1,4,7,-3,3,0,0
2548232,2,1,2,2,0,0,0,0
2558471,1,1,2,1,1,0,1,1
2558471,2,1,8,12,-4,4,0,0
2559082,1,1,5,2,3,0,3,3
2559082,2,1,2,2,0,0,0,0
2559206,1,1,0,0,0,0,0,0
2559560,2,1,0,0,0,0,0,0
2561615,1,1,12,5,7,0,7,7
2561615,2,1,7,7,0,0,0,0
2561697,1,1,6,6,0,0,0,0
2561697,2,1,5,4,1,0,1,1
2562944,1,1,15,10,5,1,6,6
2564381,2,1,9,9,0,0,0,0
2564757,1,1,0,0,0,0,0,0
2564757,2,1,4,2,2,0,2,1
2564757,3,1,2,2,0,0,0,0
2565473,1,1,8,8,0,0,0,0
2565473,3,1,0,0,0,0,0,0
2566290,1,1,0,0,0,0,0,0
2566814,1,1,8,8,0,0,0,0
2566814,2,1,0,0,0,0,0,0
2567725,1,1,3,2,1,0,1,1
2571650,1,1,5,5,0,0,0,0
2571650,2,1,9,9,0,0,0,0
2573466,1,1,6,5,1,0,1,0
2574842,1,1,7,5,2,1,3,1
2574842,2,1,4,3,1,0,1,1
2574842,3,1,8,7,1,1,2,2
2575352,1,1,4,4,0,0,0,0
2575352,2,1,3,7,-4,4,0,0
2577297,1,1,0,0,0,0,0,0
2583647,1,1,0,0,0,0,0,0
2583647,3,1,0,0,0,0,0,0
2585281,1,1,11,10,1,0,1,1
2585281,2,1,13,10,3,2,5,5
2585281,3,1,2,4,-2,2,0,0
2587099,1,1,7,3,4,0,4,4
2587099,2,1,4,4,0,2,2,2
2587099,3,1,0,0,0,0,0,0
2587557,1,1,9,7,2,0,2,2
2587557,2,1,7,7,0,0,0,0
2588260,1,1,6,10,-4,4,0,0
2588260,2,1,2,2,0,0,0,0
2588559,1,1,2,2,0,0,0,0
2590023,1,1,3,3,0,0,0,0
2590023,2,1,4,3,1,0,1,0
2591959,1,1,9,12,-3,3,0,0
2591959,2,1,8,8,0,0,0,0
2591964,1,1,8,8,0,0,0,0
2592851,1,1,2,2,0,0,0,0
2592851,2,1,2,2,0,0,0,0
2593513,1,1,4,5,-1,2,1,1
2594511,1,1,2,2,0,0,0,0
2594511,2,1,4,4,0,0,0,0
2594511,3,1,3,3,0,0,0,0
2595892,1,1,3,5,-2,2,0,0
2595892,2,1,4,4,0,0,0,0
2598220,1,1,2,6,-4,4,0,0
2598462,1,1,13,9,4,0,4,4
2598462,2,1,7,5,2,0,2,2
2598462,3,1,0,0,0,0,0,0
2598781,1,1,0,0,0,0,0,0
2598781,2,1,0,0,0,0,0,0
2598905,1,1,10,8,2,0,2,2
2599500,1,1,7,7,0,0,0,0
2599778,1,1,6,6,0,0,0,0
2599778,2,1,7,5,2,0,2,2
2599778,3,1,2,2,0,0,0,0
2600446,1,1,10,12,-2,2,0,0
2600446,3,1,0,0,0,0,0,0
2602644,1,1,4,3,1,0,1,1
2602644,2,1,0,0,0,0,0,0
2603270,1,1,9,5,4,0,4,4
2603270,2,1,5,5,0,0,0,0
2603931,1,1,5,5,0,0,0,0
2604198,1,1,14,10,4,3,7,4
2604198,2,1,3,4,-1,2,1,1
2610577,2,1,4,9,-5,5,0,0
2610577,3,1,4,2,2,0,2,2
2610667,1,1,2,2,0,0,0,0
2610667,2,1,3,2,1,0,1,1
2611500,1,1,9,4,5,0,5,5
2611500,2,1,0,0,0,0,0,0
2611500,3,1,0,0,0,0,0,0
2611665,1,1,1,5,-4,4,0,0
2613151,1,1,7,7,0,0,0,0
2613620,1,1,8,7,1,0,1,1
2613620,2,1,5,6,-1,1,0,0
2613648,1,1,1,1,0,0,0,0
2613648,2,1,0,0,0,0,0,0
2614051,1,1,0,0,0,0,0,0
2614051,2,1,4,2,2,0,2,2
2614051,3,1,4,3,1,0,1,1
2615956,1,1,4,4,0,0,0,0
2615956,2,1,0,0,0,0,0,0
2616224,1,1,6,6,0,0,0,0
2616245,1,1,7,6,1,0,1,1
2616245,2,1,4,4,0,1,1,1
2616819,1,1,0,0,0,0,0,0
2616819,2,1,0,0,0,0,0,0
2616912,1,1,3,2,1,0,1,1
2621173,1,1,5,6,-1,2,1,1
2621173,2,1,6,5,1,0,1,1
2621173,3,1,0,0,0,0,0,0
2624416,1,1,4,3,1,1,2,2
2624416,2,1,0,0,0,0,0,0
2624416,3,1,5,2,3,0,3,3
2626666,1,1,7,5,2,1,3,3
2626875,2,1,0,0,0,0,0,0
2629134,1,1,0,0,0,0,0,0
2629134,2,1,0,0,0,0,0,0
2629801,1,1,0,0,0,0,0,0
2629801,2,1,0,0,0,0,0,0
2630037,1,1,0,0,0,0,0,0
2630037,2,1,4,3,1,0,1,1
2631458,4,1,7,7,0,0,0,0
2631542,1,1,6,6,0,0,0,0
2631542,2,1,3,5,-2,2,0,0
2635543,1,1,11,7,4,0,4,3
2635543,2,1,6,5,1,0,1,1
2637077,1,1,1,1,0,0,0,0
2640300,1,1,5,5,0,0,0,0
2644078,2,1,0,0,0,0,0,0
2647572,1,1,4,2,2,0,2,2
2649077,1,1,4,4,0,0,0,0
2649077,2,1,6,6,0,0,0,0
2649077,4,1,0,0,0,0,0,0
2649623,1,1,4,4,0,0,0,0
2655507,1,1,4,4,0,0,0,0
2655507,2,1,9,8,1,0,1,0
2658273,1,1,3,3,0,0,0,0
2658273,2,1,9,7,2,0,2,2
2659800,2,1,10,8,2,0,2,1
2659800,3,1,0,0,0,0,0,0
2661733,1,1,5,9,-4,4,0,0
2661733,2,1,0,0,0,0,0,0
2662739,1,1,3,4,-1,1,0,0
2662739,2,1,10,11,-1,2,1,1
2664220,1,1,8,7,1,0,1,0
2664482,1,1,2,4,-2,2,0,0
2665141,1,1,0,0,0,0,0,0
2665141,2,1,4,4,0,0,0,0
2666303,1,1,6,6,0,0,0,0
2666303,2,1,7,6,1,0,1,1
2677070,1,1,5,5,0,0,0,0
2685957,1,1,0,0,0,0,0,0
2694134,1,1,0,0,0,0,0,0
2694134,2,1,0,0,0,0,0,0
2704358,1,1,10,4,6,1,7,7
2704358,2,1,4,2,2,0,2,2
2727759,1,1,5,4,1,0,1,1
2727759,2,1,9,7,2,0,2,2
2727759,3,1,0,0,0,0,0,0
2733679,1,1,2,2,0,0,0,0
2733679,2,1,3,3,0,0,0,0
2734252,1,1,2,2,0,0,0,0
2743817,1,1,0,0,0,0,0,0
2743817,2,1,6,6,0,0,0,0
2743817,3,1,2,2,0,0,0,0
2755140,1,1,4,3,1,0,1,1
2755204,1,1,0,0,0,0,0,0
2755204,2,1,2,4,-2,2,0,0
2755204,3,1,0,0,0,0,0,0
2768646,1,1,0,0,0,0,0,0
2772929,1,1,11,13,-2,3,1,1
2775370,1,1,4,4,0,0,0,0
2779901,1,1,2,2,0,0,0,0
2779901,2,1,5,5,0,0,0,0
2786849,1,1,4,4,0,0,0,0
2804752,1,1,7,2,5,0,5,5
2804752,2,1,13,9,4,0,4,4
2804752,3,1,5,3,2,0,2,2
2807576,1,1,3,3,0,0,0,0
2813039,1,1,5,5,0,0,0,0
2813288,1,1,3,3,0,0,0,0
2813288,2,1,0,0,0,0,0,0
2813730,1,1,6,6,0,0,0,0
2813730,2,1,0,0,0,0,0,0
2813730,3,1,11,1,10,0,10,2
2814020,1,1,10,9,1,0,1,1
2838631,1,1,3,3,0,0,0,0
2838631,2,1,7,6,1,0,1,0
2876993,1,1,4,3,1,0,1,1
2884754,1,1,5,5,0,0,0,0
2884754,2,1,0,0,0,0,0,0
2896887,1,1,0,0,0,0,0,0
2898431,1,1,4,2,2,0,2,2
2898431,2,1,9,6,3,0,3,3
2903115,1,1,0,0,0,0,0,0
2904556,1,1,5,4,1,0,1,1
2904556,2,1,5,2,3,0,3,3
2906941,1,1,18,16,2,0,2,1
2906941,2,1,6,6,0,0,0,0
2907644,1,1,0,0,0,0,0,0
2907644,2,1,0,0,0,0,0,0
2911370,1,1,4,4,0,0,0,0
2911370,2,1,4,3,1,0,1,1
2911562,1,1,3,2,1,0,1,0
2911562,2,1,4,4,0,0,0,0
2911576,1,1,0,0,0,0,0,0
2911576,2,1,0,0,0,0,0,0
2922004,1,1,0,0,0,0,0,0
2922004,2,1,7,6,1,0,1,1
2922004,3,1,1,3,-2,2,0,0
2922234,1,1,4,4,0,0,0,0
2922234,2,1,0,0,0,0,0,0
2923754,2,1,15,10,5,0,5,5
2923754,3,1,2,2,0,0,0,0
2924139,1,1,7,7,0,0,0,0
2924139,2,1,7,7,0,0,0,0
2926363,1,1,6,3,3,1,4,4
2926363,2,1,0,0,0,0,0,0
2928893,1,1,0,0,0,0,0,0
2928893,2,1,0,0,0,0,0,0
2932267,1,1,0,0,0,0,0,0
2932267,3,1,0,0,0,0,0,0
2937282,1,1,11,6,5,0,5,5
2937397,1,1,0,0,0,0,0,0
2937397,2,1,0,0,0,0,0,0
2948851,1,1,13,11,2,0,2,2
2948851,2,1,0,0,0,0,0,0
2950857,1,1,5,3,2,0,2,2
2950857,3,1,3,2,1,0,1,1
2952324,1,1,3,3,0,0,0,0
2952324,2,1,0,0,0,0,0,0
2954210,1,1,4,2,2,0,2,2
2954210,2,1,2,2,0,0,0,0
2956162,1,1,7,7,0,0,0,0
2964424,1,1,6,5,1,0,1,1
2964424,2,1,3,3,0,0,0,0
2964424,3,1,0,0,0,0,0,0
2965050,1,1,6,5,1,1,2,2
2965050,2,1,4,4,0,0,0,0
2965284,1,1,2,2,0,0,0,0
2965284,2,1,2,2,0,0,0,0
2965284,3,1,2,2,0,0,0,0
2966886,1,1,5,5,0,0,0,0
2966886,2,1,3,3,0,0,0,0
2967662,1,1,7,6,1,0,1,0
2972455,2,1,2,2,0,0,0,0
2972455,3,1,0,0,0,0,0,0
2972455,4,1,6,2,4,0,4,4
2986975,1,1,6,4,2,0,2,2
2987780,1,1,2,2,0,0,0,0
2987780,2,1,0,0,0,0,0,0
2987874,1,1,9,8,1,0,1,0
2987874,2,1,0,0,0,0,0,0
2988727,1,1,2,2,0,0,0,0
2991257,1,1,2,2,0,0,0,0
2991257,2,1,0,0,0,0,0,0
2992014,2,1,0,0,0,0,0,0
2995726,1,1,3,3,0,0,0,0
2995726,2,1,0,0,0,0,0,0
3007038,1,1,4,4,0,0,0,0
3007038,2,1,7,8,-1,1,0,0
3007943,1,1,4,4,0,0,0,0
3013313,1,1,2,2,0,0,0,0
3018114,1,1,2,2,0,0,0,0
3018114,2,1,0,0,0,0,0,0
3024607,1,1,6,6,0,0,0,0
3024607,2,1,1,1,0,0,0,0
3032159,1,1,3,2,1,0,1,1
3032211,1,1,4,4,0,0,0,0
3032589,2,1,0,0,0,0,0,0
3033043,1,1,4,5,-1,1,0,0
3033120,1,1,5,5,0,0,0,0
3033120,2,1,14,9,5,0,5,5
3033454,1,1,6,6,0,0,0,0
3033454,2,1,7,6,1,0,1,1
3039616,1,1,3,3,0,0,0,0
3043478,1,1,4,2,2,0,2,1
3044676,1,1,2,2,0,0,0,0
3044676,2,1,0,0,0,0,0,0
3044940,1,1,7,7,0,0,0,0
3044940,2,1,0,0,0,0,0,0
3045888,1,1,8,6,2,0,2,2
3045888,2,1,0,0,0,0,0,0
3055600,1,1,10,10,0,0,0,0
3055600,2,1,9,8,1,0,1,0
3062953,1,1,3,3,0,0,0,0
3062953,2,1,0,0,0,0,0,0
3063358,1,1,0,0,0,0,0,0
3063358,2,1,0,0,0,0,0,0
3063680,1,1,0,0,0,0,0,0
3063680,2,1,0,0,0,0,0,0
3064216,1,1,0,0,0,0,0,0
3070054,1,1,5,5,0,0,0,0
3070054,2,1,2,2,0,0,0,0
3070721,1,1,6,1,5,0,5,5
3074371,2,1,0,0,0,0,0,0
3074371,3,1,0,0,0,0,0,0
3078581,1,1,0,0,0,0,0,0
3078581,2,1,0,0,0,0,0,0
3078581,3,1,0,0,0,0,0,0
3078773,1,1,2,2,0,0,0,0
3078773,2,1,2,2,0,0,0,0
3079415,2,1,0,0,0,0,0,0
3079415,3,1,4,3,1,0,1,1
3083398,1,1,4,3,1,0,1,0
3083398,2,1,8,8,0,0,0,0
3083402,1,1,14,11,3,0,3,3
3083402,2,1,3,3,0,0,0,0
3083404,1,1,6,6,0,0,0,0
3083404,2,1,6,6,0,0,0,0
3083405,1,1,2,2,0,0,0,0
3083405,2,1,4,4,0,0,0,0
3083405,3,1,4,4,0,0,0,0
3083408,1,1,8,6,2,0,2,2
7187961,1,1,3,3,0,0,0,0
7187961,2,1,7,7,0,0,0,0
7187965,1,1,3,5,-2,3,1,0
7187965,2,1,8,8,0,0,0,0
7187965,3,1,0,0,0,0,0,0
7187967,2,1,4,3,1,0,1,1
7187967,4,1,0,0,0,0,0,0
7187967,5,1,2,5,-3,3,0,0
7187969,1,1,4,3,1,0,1,0
7187969,2,1,4,3,1,0,1,1
7187978,1,1,1,2,-1,1,0,0
7187978,2,1,2,4,-2,2,0,0
7187978,3,1,0,0,0,0,0,0
7187981,1,1,9,7,2,0,2,2
7187981,2,1,0,0,0,0,0,0
7187983,1,1,4,3,1,0,1,1
7187983,2,1,0,0,0,0,0,0
7187987,1,1,2,2,0,0,0,0
7187987,2,1,6,6,0,0,0,0
7187988,1,1,0,0,0,0,0,0
7187988,2,1,2,2,0,0,0,0
7187988,3,1,0,0,0,0,0,0
7187990,1,1,5,4,1,0,1,1
7187990,2,1,0,0,0,0,0,0
7187995,1,1,0,0,0,0,0,0
7187995,2,1,0,0,0,0,0,0
7187996,1,1,4,6,-2,2,0,0
7187996,2,1,0,0,0,0,0,0
7187996,3,1,0,0,0,0,0,0
7187998,1,1,5,5,0,0,0,0
7187998,2,1,4,4,0,0,0,0
7187998,3,1,0,0,0,0,0,0
7188004,1,1,7,6,1,0,1,0
7188004,2,1,0,0,0,0,0,0
7188004,3,1,0,0,0,0,0,0
7188011,1,1,5,5,0,0,0,0
7188012,1,1,4,4,0,0,0,0
7188012,2,1,2,2,0,0,0,0
7188018,1,1,6,2,4,0,4,4
7188018,2,1,11,11,0,0,0,0
7188018,3,1,2,2,0,0,0,0
7188021,1,1,4,4,0,0,0,0
7188021,2,1,2,2,0,0,0,0
7188024,1,1,4,2,2,0,2,1
7188024,2,1,2,2,0,0,0,0
7188024,3,1,4,2,2,0,2,1
7188032,1,1,2,2,0,0,0,0
7188032,2,1,12,7,5,0,5,5
7188032,3,1,0,0,0,0,0,0
7188034,1,1,5,5,0,0,0,0
7188034,2,1,0,0,0,0,0,0
7188035,1,1,0,0,0,0,0,0
7188035,2,1,4,2,2,0,2,2
7188035,3,1,0,0,0,0,0,0
7188046,1,1,0,0,0,0,0,0
7188046,2,1,5,6,-1,1,0,0
7188053,1,1,7,7,0,0,0,0
7188053,2,1,8,7,1,0,1,1
7188054,1,1,3,2,1,0,1,1
7188054,2,1,2,2,0,0,0,0
7188058,2,1,6,6,0,0,0,0
7188058,3,1,0,0,0,0,0,0
7188058,4,1,6,6,0,0,0,0
7188060,2,1,0,0,0,0,0,0
7188060,3,1,0,0,0,0,0,0
7188068,1,1,3,5,-2,2,0,0
7188068,2,1,4,3,1,0,1,1
7188068,3,1,10,8,2,0,2,2
7188069,1,1,0,0,0,0,0,0
7188069,2,1,6,6,0,0,0,0
7188069,3,1,8,7,1,0,1,0
7188084,1,1,6,6,0,0,0,0
7188084,2,1,4,4,0,0,0,0
7188085,1,1,7,6,1,0,1,1
7188085,2,1,5,5,0,0,0,0
7188086,1,1,6,6,0,0,0,0
7188089,1,1,0,0,0,0,0,0
7188089,2,1,0,0,0,0,0,0
7188090,1,1,2,2,0,0,0,0
7188090,2,1,2,2,0,0,0,0
7188096,1,1,2,2,0,0,0,0
7188096,2,1,2,2,0,0,0,0
7188102,1,1,4,3,1,0,1,1
7188102,2,1,0,0,0,0,0,0
7188107,2,1,2,2,0,0,0,0
7188113,1,1,2,2,0,0,0,0
7188113,2,1,0,0,0,0,0,0
7188118,1,1,0,0,0,0,0,0
7188118,2,1,3,3,0,0,0,0
7188118,3,1,12,11,1,0,1,0
7188119,1,1,9,7,2,0,2,2
7188119,2,1,4,6,-2,2,0,0
7188129,1,1,3,3,0,0,0,0
7188130,1,1,3,3,0,0,0,0
7188130,2,1,5,4,1,0,1,1
7188131,2,1,0,0,0,0,0,0
7188131,3,1,2,2,0,0,0,0
7188134,2,1,0,0,0,0,0,0
7188134,3,1,2,7,-5,5,0,0
7188138,1,1,5,5,0,0,0,0
7188138,2,1,0,0,0,0,0,0
7188144,1,1,10,8,2,0,2,2
7188144,2,1,7,6,1,0,1,0
7188167,1,1,6,4,2,0,2,2
7188167,2,1,0,0,0,0,0,0
7188204,1,1,8,7,1,0,1,1
7188204,2,1,0,0,0,0,0,0
7188209,1,1,2,2,0,0,0,0
7188209,2,1,3,3,0,0,0,0
7188232,1,1,3,3,0,0,0,0
7188232,2,1,10,10,0,0,0,0
7188232,3,1,0,0,0,0,0,0
7188234,1,1,0,0,0,0,0,0
7188234,2,1,5,4,1,0,1,1
7188235,1,1,3,3,0,0,0,0
7188235,2,1,0,0,0,0,0,0
7188235,3,1,0,0,0,0,0,0
7188250,1,1,5,5,0,0,0,0
7188271,1,1,5,3,2,0,2,2
7188271,2,1,5,5,0,0,0,0
7188276,1,1,8,6,2,1,3,3
7188276,2,1,0,0,0,0,0,0
7188277,1,1,2,2,0,0,0,0
7188277,2,1,4,4,0,0,0,0
7188277,3,1,0,0,0,0,0,0
7188280,1,1,10,10,0,0,0,0
7188284,1,1,8,8,0,0,0,0
7188284,2,1,0,0,0,0,0,0
7188290,1,1,2,2,0,0,0,0
7188290,2,1,5,2,3,0,3,3
7188291,1,1,5,5,0,0,0,0
7188302,1,1,4,6,-2,2,0,0
7188302,2,1,0,0,0,0,0,0
7188302,3,1,3,3,0,0,0,0
7188308,1,1,4,4,0,0,0,0
7188308,2,1,6,2,4,0,4,4
7188312,1,1,4,4,0,0,0,0
7188312,2,1,7,6,1,0,1,1
7188312,3,1,0,0,0,0,0,0
7188313,1,1,4,4,0,0,0,0
7188313,3,1,6,6,0,0,0,0
7188318,1,1,6,4,2,0,2,2
7188318,2,1,0,0,0,0,0,0
7188320,1,1,8,7,1,0,1,1
7188320,2,1,9,7,2,0,2,2
7188329,1,1,7,7,0,0,0,0
7188329,2,1,0,0,0,0,0,0
7188329,3,1,5,5,0,0,0,0
7188332,1,1,7,6,1,0,1,1
7188332,2,1,0,0,0,0,0,0
7188339,1,1,9,7,2,0,2,2
7188346,1,1,6,5,1,0,1,1
7188346,2,1,0,0,0,0,0,0
7188346,3,1,0,0,0,0,0,0
7188365,1,1,5,5,0,0,0,0
7188365,2,1,0,0,0,0,0,0
7188366,1,1,6,8,-2,3,1,1
7188366,2,1,0,0,0,0,0,0
7188370,1,1,5,5,0,0,0,0
7188370,2,1,4,4,0,0,0,0
7188370,3,1,0,0,0,0,0,0
7188425,1,1,2,2,0,0,0,0
7188425,2,1,0,0,0,0,0,0
7188425,3,1,8,7,1,0,1,1
7201026,1,1,5,2,3,0,3,3
7201026,2,1,3,3,0,0,0,0
7201038,1,1,6,5,1,0,1,1
7201166,1,1,2,2,0,0,0,0
7201166,2,1,5,5,0,0,0,0
7201391,1,1,17,8,9,0,9,3
7201391,2,1,0,0,0,0,0,0
7201956,1,1,9,2,7,1,8,5
7201956,2,1,0,0,0,0,0,0
7202301,1,1,6,4,2,2,4,3
7202865,1,1,0,0,0,0,0,0
7202865,2,1,0,0,0,0,0,0
7202904,1,1,2,2,0,0,0,0
7202916,1,1,5,4,1,0,1,1
7202916,2,1,5,5,0,0,0,0
7202949,1,1,0,0,0,0,0,0
7202992,1,1,4,5,-1,1,0,0
7202992,2,1,3,3,0,0,0,0
7203146,1,1,5,4,1,0,1,1
7203347,1,1,2,2,0,0,0,0
7203347,2,1,0,0,0,0,0,0
7203371,1,1,5,5,0,0,0,0
7203602,3,1,0,0,0,0,0,0
7203789,1,1,4,4,0,0,0,0
7203789,2,1,0,0,0,0,0,0
7204165,2,1,5,3,2,1,3,3
7204241,1,1,0,0,0,0,0,0
7204268,1,1,6,5,1,0,1,1
7204268,2,1,3,3,0,0,0,0
7204347,2,1,6,4,2,0,2,2
7204379,1,1,5,2,3,0,3,3
7204379,2,1,0,0,0,0,0,0
7204380,1,1,0,0,0,0,0,0
7204380,2,1,0,0,0,0,0,0
7204390,1,1,11,9,2,0,2,2
7204390,2,1,2,4,-2,2,0,0
7208991,1,1,5,5,0,0,0,0
7208991,2,1,3,4,-1,2,1,1
7209398,2,1,0,0,0,0,0,0
7209398,4,1,0,0,0,0,0,0
7209686,1,1,9,9,0,0,0,0
7209686,3,1,5,4,1,0,1,1
7209751,1,1,9,7,2,0,2,0
7211944,1,1,10,6,4,0,4,2
7211944,2,1,2,2,0,0,0,0
7211944,3,1,13,2,11,0,11,11
