sampno,vehno,gpsdiarycomplete,nbgpstripsdiaryday,nbdiaryreportedtrips,rawmatchdifference,nbmissinggpstrips,nbmissingdiarytrips,nbadjustedmissdiary
1035198,1,1,2,2,0,0,0,0
1035198,3,1,10,5,5,0,5,5
1037295,1,1,3,2,1,0,1,1
1037751,1,1,3,3,0,0,0,0
1044414,1,1,8,8,0,0,0,0
1044596,1,1,9,5,4,0,4,4
1044596,2,1,0,0,0,0,0,0
1044596,3,1,0,0,0,0,0,0
1051649,1,1,2,2,0,0,0,0
1051649,2,1,5,2,3,0,3,3
1051649,3,1,2,2,0,0,0,0
1051795,1,1,0,0,0,0,0,0
1051795,2,1,10,7,3,0,3,3
1054803,1,1,4,4,0,0,0,0
1054803,2,1,0,0,0,0,0,0
1054933,1,1,0,0,0,0,0,0
1057600,1,1,0,0,0,0,0,0
1119025,1,1,8,5,3,1,4,3
1119025,2,1,0,0,0,0,0,0
1119055,1,1,6,6,0,0,0,0
1119055,2,1,3,3,0,0,0,0
1119070,1,1,10,9,1,0,1,1
1119070,2,1,7,5,2,0,2,2
1119070,3,1,0,0,0,0,0,0
1119821,1,1,0,0,0,0,0,0
1119821,2,1,3,3,0,0,0,0
1119821,3,1,2,2,0,0,0,0
1120424,1,1,7,4,3,0,3,3
1120424,2,1,0,0,0,0,0,0
1120935,1,1,2,2,0,0,0,0
1120935,2,1,10,9,1,1,2,2
1121105,1,1,0,0,0,0,0,0
1121105,2,1,12,7,5,0,5,5
1121290,1,1,5,6,-1,1,0,0
1121290,2,1,0,0,0,0,0,0
1123111,1,1,7,4,3,0,3,3
1123111,2,1,2,2,0,0,0,0
1123227,1,1,0,0,0,0,0,0
1123227,2,1,0,0,0,0,0,0
1125362,1,1,7,6,1,0,1,0
1125362,2,1,3,2,1,0,1,0
1125585,1,1,2,2,0,0,0,0
1125585,2,1,3,3,0,0,0,0
1128195,1,1,15,7,8,0,8,8
1128811,1,1,15,9,6,0,6,6
1128811,2,1,6,7,-1,1,0,0
1129234,1,1,4,3,1,0,1,1
1130487,1,1,2,2,0,0,0,0
1130487,2,1,6,5,1,1,2,2
1130604,1,1,14,10,4,0,4,4
1131660,1,1,4,4,0,0,0,0
1131660,2,1,0,0,0,0,0,0
1132564,1,1,5,4,1,0,1,1
1134039,1,1,0,0,0,0,0,0
1134470,1,1,4,5,-1,1,0,0
1134470,2,1,0,0,0,0,0,0
1134721,2,1,6,4,2,0,2,2
1134742,1,1,8,7,1,0,1,1
1134742,2,1,4,4,0,0,0,0
1135317,1,1,4,4,0,0,0,0
1135317,2,1,18,16,2,0,2,1
1135317,3,1,0,0,0,0,0,0
1135438,1,1,3,2,1,0,1,1
1135438,2,1,2,2,0,1,0,0
1135955,1,1,2,2,0,0,0,0
1135955,2,1,6,6,0,0,0,0
1137549,1,1,9,9,0,0,0,0
1137549,2,1,5,4,1,0,1,1
1137920,1,1,0,0,0,0,0,0
1138010,1,1,3,4,-1,3,2,2
1138442,1,1,0,0,0,0,0,0
1139416,1,1,5,4,1,0,1,1
1139422,1,1,5,4,1,0,1,1
1139818,1,1,5,5,0,0,0,0
1139945,1,1,5,5,0,0,0,0
1140006,1,1,3,3,0,0,0,0
1140006,2,1,4,5,-1,2,0,0
1140006,3,1,0,0,0,0,0,0
1140735,1,1,14,8,6,0,6,6
1140735,2,1,2,4,-2,2,0,0
1140800,2,1,13,11,2,1,3,3
1141076,1,1,10,4,6,0,6,6
1141873,1,1,7,2,5,0,5,5
1142708,1,1,0,0,0,0,0,0
1142708,2,1,6,2,4,0,4,4
1143815,1,1,0,0,0,0,0,0
1143815,2,1,0,0,0,0,0,0
1144043,1,1,0,0,0,0,0,0
1144441,1,1,0,0,0,0,0,0
1144441,2,1,0,0,0,0,0,0
1144883,1,1,5,5,0,0,0,0
1144883,3,1,3,3,0,0,0,0
1146542,1,1,4,4,0,0,0,0
1146678,1,1,6,3,3,0,3,3
1146678,2,1,5,5,0,0,0,0
1146678,3,1,0,0,0,0,0,0
1147504,1,1,3,5,-2,3,1,1
1147504,2,1,3,2,1,0,1,1
1147504,3,1,0,0,0,0,0,0
1149328,1,1,0,0,0,0,0,0
1149328,2,1,0,0,0,0,0,0
1150104,1,1,4,3,1,0,1,1
1150104,2,1,0,0,0,0,0,0
1150191,1,1,0,0,0,0,0,0
1150191,2,1,10,12,-2,2,0,0
1151151,1,1,0,0,0,0,0,0
1151384,1,1,5,3,2,0,2,2
1151384,2,1,7,4,3,0,3,3
1151498,1,1,4,4,0,0,0,0
1151498,2,1,10,9,1,0,1,1
1151794,1,1,0,0,0,0,0,0
1151794,2,1,0,0,0,0,0,0
1152022,1,1,4,4,0,0,0,0
1152022,2,1,5,6,-1,1,0,0
1152646,1,1,6,5,1,0,1,1
1152646,2,1,6,5,1,0,1,0
1153250,1,1,8,6,2,0,2,1
1153250,2,1,0,0,0,0,0,0
1153377,1,1,0,0,0,0,0,0
1154089,1,1,14,5,9,0,9,7
1154089,3,1,7,5,2,2,4,2
1155144,1,1,15,6,9,0,9,9
1155158,1,1,8,10,-2,2,0,0
1155158,2,1,1,2,-1,1,0,0
1156622,1,1,6,6,0,0,0,0
1156622,2,1,2,2,0,0,0,0
1156732,1,1,2,2,0,0,0,0
1156732,2,1,10,8,2,0,2,2
1157183,2,1,3,2,1,0,1,1
1157183,3,1,14,10,4,0,4,4
1158232,1,1,4,3,1,0,1,1
1158232,2,1,2,2,0,0,0,0
1158552,1,1,8,6,2,0,2,1
1158552,2,1,3,3,0,0,0,0
1158632,1,1,3,4,-1,2,1,1
1158632,2,1,0,0,0,0,0,0
1158632,3,1,6,6,0,0,0,0
1158877,1,1,6,3,3,0,3,2
1158877,2,1,0,0,0,0,0,0
1158941,1,1,12,0,12,0,10,10
1158941,3,1,0,0,0,0,0,0
1159003,1,1,13,12,1,0,1,0
1178633,1,1,4,4,0,0,0,0
1178633,2,1,9,9,0,1,1,1
1179644,1,1,2,2,0,0,0,0
1186814,1,1,7,6,1,0,1,1
1186814,2,1,0,0,0,0,0,0
1190101,1,1,3,5,-2,3,1,1
1190101,3,1,0,0,0,0,0,0
1207379,1,1,3,7,-4,4,0,0
1207379,2,1,0,0,0,0,0,0
1208803,1,1,4,4,0,0,0,0
1208803,2,1,0,0,0,0,0,0
1209027,1,1,6,10,-4,4,0,0
1209027,2,1,2,6,-4,5,1,1
1210204,1,1,0,0,0,0,0,0
1210868,1,1,0,0,0,0,0,0
1223692,1,1,7,1,6,0,6,2
1224932,1,1,0,0,0,0,0,0
1224932,2,1,0,0,0,0,0,0
1225329,1,1,0,0,0,0,0,0
1234336,1,1,7,7,0,0,0,0
1234336,2,1,5,5,0,0,0,0
1235282,1,1,2,2,0,0,0,0
1235282,2,1,2,2,0,0,0,0
1236363,1,1,2,2,0,0,0,0
1240624,1,1,6,6,0,0,0,0
1242543,1,1,0,0,0,0,0,0
1256261,1,1,5,6,-1,1,0,0
1256261,2,1,0,0,0,0,0,0
1260457,1,1,0,0,0,0,0,0
1260457,2,1,5,4,1,0,1,1
1260457,3,1,0,0,0,0,0,0
1264399,1,1,2,2,0,0,0,0
1264399,2,1,6,6,0,0,0,0
1264982,1,1,4,3,1,0,1,0
1264982,2,1,0,0,0,0,0,0
1282541,1,1,5,4,1,0,1,1
1290034,1,1,8,8,0,0,0,0
1290034,2,1,0,0,0,0,0,0
1295325,1,1,10,9,1,0,1,0
1302642,1,1,0,0,0,0,0,0
1309284,1,1,7,6,1,0,1,0
1318928,1,1,4,4,0,0,0,0
1319784,1,1,2,2,0,0,0,0
1319784,2,1,0,0,0,0,0,0
1319784,3,1,3,3,0,0,0,0
1320244,1,1,5,5,0,0,0,0
1321768,1,1,9,10,-1,1,0,0
1325736,1,1,6,6,0,0,0,0
1330361,1,1,4,2,2,0,2,2
1330361,2,1,0,0,0,0,0,0
1333141,1,1,2,2,0,0,0,0
1339275,1,1,8,6,2,0,2,2
1346841,1,1,2,2,0,0,0,0
1346841,2,1,0,0,0,0,0,0
1353726,1,1,14,8,6,0,6,6
1354121,1,1,0,0,0,0,0,0
1356673,1,1,0,0,0,0,0,0
1356673,2,1,0,0,0,0,0,0
1356673,3,1,13,2,11,0,11,11
1365783,1,1,10,2,8,0,8,8
1365783,2,1,0,0,0,0,0,0
1374265,1,1,9,6,3,0,3,3
1374265,2,1,1,2,-1,1,0,0
1374265,3,1,0,0,0,0,0,0
1375576,1,1,10,6,4,0,4,4
1375576,2,1,2,2,0,2,0,0
1376484,1,1,5,5,0,0,0,0
1387013,1,1,11,9,2,0,2,2
1387013,2,1,2,3,-1,1,0,0
1390363,1,1,6,5,1,0,1,1
1390363,2,1,0,0,0,0,0,0
1390363,3,1,0,0,0,0,0,0
1390543,1,1,2,2,0,0,0,0
1400320,1,1,0,0,0,0,0,0
1400320,2,1,0,0,0,0,0,0
1402529,1,1,0,0,0,0,0,0
1402529,2,1,2,1,1,0,1,0
1407588,1,1,2,2,0,0,0,0
1407588,2,1,0,0,0,0,0,0
1411889,1,1,0,0,0,0,0,0
1411889,2,1,10,9,1,0,1,1
1411889,3,1,1,1,0,0,0,0
1430629,1,1,0,0,0,0,0,0
1430629,2,1,12,4,8,0,8,8
1433441,1,1,5,4,1,1,2,2
1433441,2,1,17,13,4,0,4,4
1433441,3,1,6,4,2,0,2,2
1437535,1,1,4,3,1,0,1,1
1437535,2,1,4,4,0,0,0,0
1437575,1,1,0,0,0,0,0,0
1437575,2,1,0,0,0,0,0,0
1442488,1,1,3,3,0,0,0,0
1442488,2,1,0,0,0,0,0,0
1452274,1,1,0,0,0,0,0,0
1452274,2,1,6,3,3,0,3,3
1452274,3,1,4,4,0,1,1,1
1454465,1,1,4,4,0,0,0,0
1458064,1,1,2,2,0,0,0,0
1458064,2,1,0,0,0,0,0,0
1470126,1,1,0,0,0,0,0,0
1470126,3,1,2,2,0,0,0,0
1480542,1,1,0,0,0,0,0,0
1480542,2,1,0,0,0,0,0,0
1502994,1,1,4,9,-5,5,0,0
1502994,3,1,4,2,2,0,2,2
1521424,1,1,0,0,0,0,0,0
1523534,1,1,0,0,0,0,0,0
1523534,2,1,0,0,0,0,0,0
1523534,3,1,0,0,0,0,0,0
1532601,1,1,6,5,1,0,1,1
1532601,2,1,0,0,0,0,0,0
1675855,1,1,5,5,0,0,0,0
1675855,2,1,2,2,0,0,0,0
1675855,3,1,6,5,1,0,1,1
1677168,1,1,8,7,1,0,1,1
1680806,1,1,3,4,-1,1,0,0
1680876,1,1,9,9,0,2,2,2
1680876,2,1,11,9,2,0,2,2
1680876,3,1,7,3,4,0,4,4
1681108,1,1,5,5,0,0,0,0
1681108,2,1,10,7,3,0,3,3
1682285,1,1,0,0,0,0,0,0
1682456,1,1,0,0,0,0,0,0
1682456,2,1,0,0,0,0,0,0
1682791,1,1,3,3,0,0,0,0
1682791,2,1,16,10,6,1,7,6
1687233,1,1,3,3,0,0,0,0
1687233,2,1,0,0,0,0,0,0
1690986,1,1,5,9,-4,4,0,0
1690986,2,1,0,0,0,0,0,0
1690986,3,1,0,0,0,0,0,0
1693087,1,1,6,6,0,0,0,0
1693087,2,1,0,0,0,0,0,0
1697721,2,1,0,0,0,0,0,0
1697721,3,1,0,0,0,0,0,0
1698967,1,1,0,0,0,0,0,0
1699031,1,1,5,5,0,0,0,0
1699031,2,1,3,3,0,0,0,0
1699793,1,1,17,15,2,0,2,2
1699793,2,1,2,2,0,0,0,0
1702618,1,1,4,4,0,0,0,0
1707867,1,1,13,12,1,0,1,1
1708202,1,1,0,0,0,0,0,0
1708202,2,1,0,0,0,0,0,0
1709773,1,1,0,0,0,0,0,0
1710984,1,1,0,0,0,0,0,0
1710984,2,1,0,0,0,0,0,0
1711486,1,1,2,3,-1,1,0,0
1711486,2,1,1,1,0,0,0,0
1712590,1,1,3,4,-1,2,1,1
1712590,2,1,2,2,0,0,0,0
1712705,1,1,0,0,0,0,0,0
1712705,2,1,4,4,0,0,0,0
1712705,3,1,0,0,0,0,0,0
1717746,1,1,0,0,0,0,0,0
1717746,2,1,9,7,2,0,2,2
1718977,1,1,9,9,0,0,0,0
1718977,2,1,5,6,-1,1,0,0
1720933,1,1,0,0,0,0,0,0
1722424,1,1,0,0,0,0,0,0
1723488,1,1,0,0,0,0,0,0
1725871,1,1,3,3,0,0,0,0
1725871,2,1,0,0,0,0,0,0
1726361,1,1,4,3,1,0,1,1
1726361,2,1,0,0,0,0,0,0
1726782,3,1,5,6,-1,2,1,1
1726782,4,1,4,3,1,0,1,1
1729827,2,1,0,0,0,0,0,0
1729827,3,1,8,3,5,0,5,4
1730973,2,1,0,0,0,0,0,0
1735179,1,1,3,3,0,0,0,0
1735179,2,1,0,0,0,0,0,0
1738720,1,1,0,0,0,0,0,0
1738720,2,1,0,0,0,0,0,0
1740787,1,1,0,0,0,0,0,0
1742095,1,1,6,6,0,0,0,0
1742095,2,1,6,2,4,0,4,4
1743264,1,1,8,4,4,0,4,4
1743264,2,1,0,0,0,0,0,0
1743805,1,1,2,2,0,0,0,0
1746498,1,1,2,2,0,0,0,0
1746498,2,1,0,0,0,0,0,0
1747105,1,1,1,2,-1,0,0,0
1747105,2,1,0,0,0,0,0,0
1751392,1,1,3,2,1,0,1,1
1751392,2,1,0,0,0,0,0,0
1757501,1,1,4,4,0,0,0,0
1763198,1,1,6,6,0,0,0,0
1766425,2,1,0,0,0,0,0,0
1768608,1,1,2,2,0,0,0,0
1768608,2,1,5,5,0,0,0,0
1771038,1,1,0,0,0,0,0,0
1771038,2,1,0,0,0,0,0,0
1771163,1,1,17,12,5,0,5,5
1771163,2,1,34,10,24,0,24,3
1772847,1,1,5,5,0,0,0,0
1772847,2,1,5,5,0,0,0,0
1773708,1,1,5,5,0,0,0,0
1775272,1,1,7,6,1,0,1,1
1775272,2,1,0,0,0,0,0,0
1776019,1,1,14,11,3,0,3,3
1776019,2,1,2,2,0,0,0,0
1817256,1,1,5,4,1,0,1,1
1817256,2,1,0,0,0,0,0,0
1831201,1,1,6,4,2,0,2,2
1831201,2,1,0,0,0,0,0,0
1843302,1,1,6,5,1,0,1,1
1843302,2,1,8,7,1,0,1,1
1843677,1,1,0,0,0,0,0,0
1843677,2,1,3,3,0,0,0,0
1844702,1,1,5,5,0,0,0,0
1856374,1,1,4,4,0,0,0,0
1856374,2,1,2,2,0,0,0,0
1856374,3,1,2,2,0,0,0,0
1898041,1,1,11,5,6,0,6,6
1898041,2,1,6,3,3,0,3,3
1898041,3,1,7,5,2,0,2,2
1909198,1,1,9,9,0,0,0,0
1909198,2,1,7,5,2,0,2,2
1909198,3,1,0,0,0,0,0,0
1976414,1,1,5,5,0,0,0,0
1976414,2,1,2,2,0,0,0,0
1987680,1,1,4,4,0,0,0,0
1987680,2,1,5,5,0,0,0,0
1987680,3,1,1,1,0,0,0,0
2016749,1,1,4,4,0,0,0,0
2016749,2,1,0,0,0,0,0,0
2016749,3,1,0,0,0,0,0,0
2017211,1,1,0,0,0,0,0,0
2022086,1,1,5,4,1,0,1,1
2045487,1,1,2,4,-2,2,0,0
2045487,2,1,6,9,-3,3,0,0
2045730,1,1,11,11,0,0,0,0
2045730,2,1,4,4,0,0,0,0
2045730,3,1,1,2,-1,1,0,0
2046304,2,1,2,2,0,0,0,0
2052046,1,1,3,3,0,0,0,0
2052046,2,1,8,5,3,0,3,3
2055542,1,1,5,5,0,0,0,0
2059750,1,1,5,4,1,0,1,1
2060835,1,1,0,0,0,0,0,0
2061644,1,1,2,2,0,0,0,0
2061644,2,1,4,2,2,0,2,2
2065077,1,1,1,2,-1,1,0,0
2067735,1,1,1,2,-1,1,0,0
2076915,1,1,6,4,2,0,2,2
2076915,2,1,8,6,2,0,2,2
2077038,1,1,2,2,0,0,0,0
2079481,1,1,3,4,-1,2,0,0
2079870,1,1,0,0,0,0,0,0
2081194,1,1,3,3,0,0,0,0
2087385,1,1,4,3,1,0,1,1
2089020,1,1,2,2,0,0,0,0
2089020,2,1,0,0,0,0,0,0
2089020,3,1,0,0,0,0,0,0
2089664,1,1,2,2,0,0,0,0
2090417,1,1,0,0,0,0,0,0
2090417,2,1,4,4,0,1,1,1
2091575,1,1,0,0,0,0,0,0
2091575,2,1,0,0,0,0,0,0
2092013,1,1,0,0,0,0,0,0
2093623,1,1,3,2,1,0,1,1
2093623,2,1,4,4,0,0,0,0
2093665,1,1,4,4,0,0,0,0
2094759,1,1,6,6,0,0,0,0
2094759,2,1,2,2,0,0,0,0
2097623,1,1,5,6,-1,1,0,0
2097623,2,1,0,0,0,0,0,0
2102763,1,1,16,12,4,0,4,4
2102763,2,1,0,0,0,0,0,0
2105161,1,1,2,2,0,0,0,0
2109168,1,1,0,0,0,0,0,0
2110228,1,1,6,6,0,0,0,0
2110228,2,1,0,0,0,0,0,0
2111735,1,1,2,2,0,0,0,0
2111735,2,1,2,2,0,0,0,0
2112938,1,1,0,0,0,0,0,0
2113763,1,1,2,1,1,0,1,1
2115522,1,1,11,7,4,0,4,4
2118071,1,1,0,0,0,0,0,0
2118071,2,1,8,8,0,0,0,0
2118071,3,1,6,6,0,0,0,0
2124189,1,1,0,0,0,0,0,0
2124189,2,1,3,3,0,0,0,0
2131756,1,1,0,0,0,0,0,0
2131756,2,1,0,0,0,0,0,0
2138491,1,1,2,2,0,1,1,1
2138491,2,1,3,2,1,0,1,1
2140668,1,1,2,2,0,0,0,0
2140668,2,1,0,0,0,0,0,0
2142467,1,1,2,2,0,0,0,0
2142467,2,1,8,8,0,0,0,0
2142774,1,1,7,7,0,0,0,0
2143135,1,1,7,7,0,0,0,0
2143234,1,1,0,0,0,0,0,0
2143234,2,1,2,2,0,0,0,0
2145125,1,1,3,3,0,0,0,0
2158234,1,1,7,7,0,0,0,0
2160062,1,1,5,5,0,0,0,0
2160062,2,1,0,0,0,0,0,0
2160062,3,1,2,2,0,0,0,0
2164601,2,1,2,2,0,0,0,0
2169564,1,1,12,7,5,2,7,7
2171118,1,1,5,5,0,1,1,1
2171118,2,1,4,3,1,0,1,1
2172179,1,1,4,4,0,0,0,0
2172179,2,1,13,13,0,0,0,0
2173648,1,1,6,5,1,0,1,1
2174068,1,1,8,4,4,0,4,4
2174068,2,1,7,6,1,0,1,1
2175988,1,1,2,2,0,0,0,0
2177861,1,1,3,3,0,0,0,0
2179333,1,1,0,0,0,0,0,0
2179333,2,1,4,4,0,0,0,0
2183489,1,1,16,16,0,0,0,0
2183999,1,1,6,6,0,0,0,0
2183999,2,1,3,2,1,0,1,1
2189741,1,1,6,6,0,0,0,0
2189741,2,1,4,4,0,0,0,0
2189741,3,1,0,0,0,0,0,0
2192767,1,1,0,0,0,0,0,0
2194348,1,1,4,4,0,1,1,1
2194710,1,1,14,12,2,0,2,2
2194710,2,1,4,4,0,0,0,0
2194710,3,1,10,6,4,0,4,4
2195394,1,1,3,3,0,0,0,0
2195580,1,1,9,9,0,0,0,0
2195942,1,1,5,4,1,0,1,1
2195942,2,1,2,2,0,0,0,0
2197883,1,1,2,3,-1,1,0,0
2197883,2,1,4,2,2,0,2,2
2199289,1,1,9,5,4,0,4,4
2199289,2,1,0,0,0,0,0,0
2199501,1,1,0,0,0,0,0,0
2199501,2,1,0,0,0,0,0,0
2200752,1,1,4,4,0,0,0,0
2201952,1,1,0,0,0,0,0,0
2203100,1,1,3,2,1,0,1,1
2203100,2,1,3,3,0,0,0,0
2206467,1,1,8,7,1,0,1,1
2215330,1,1,8,7,1,0,1,1
2215330,2,1,2,2,0,0,0,0
2215330,3,1,2,2,0,0,0,0
2217304,1,1,3,2,1,0,1,1
2218485,1,1,8,9,-1,1,0,0
2218485,2,1,4,4,0,0,0,0
2225855,1,1,7,6,1,0,1,1
2233056,1,1,2,2,0,0,0,0
2233056,2,1,10,10,0,0,0,0
2235192,1,1,8,10,-2,2,0,0
2236050,1,1,2,2,0,0,0,0
2236330,1,1,0,0,0,0,0,0
2236330,2,1,0,0,0,0,0,0
2236435,1,1,3,2,1,0,1,1
2236435,2,1,7,7,0,0,0,0
2239007,1,1,5,5,0,0,0,0
2239382,1,1,9,7,2,0,2,2
2246360,1,1,4,4,0,0,0,0
2246360,3,1,4,4,0,0,0,0
2246809,1,1,2,2,0,0,0,0
2246809,2,1,0,0,0,0,0,0
2248993,1,1,3,3,0,0,0,0
2252043,1,1,0,0,0,0,0,0
2253040,2,1,0,0,0,0,0,0
2253778,1,1,4,5,-1,2,1,1
2253778,2,1,0,0,0,0,0,0
2253778,3,1,5,5,0,0,0,0
2255433,1,1,0,0,0,0,0,0
2255433,2,1,0,0,0,0,0,0
2259514,1,1,3,2,1,0,1,1
2259514,2,1,0,0,0,0,0,0
2261479,1,1,1,12,-11,11,0,0
2264740,1,1,4,3,1,1,2,2
2264830,1,1,4,6,-2,3,1,1
2264830,2,1,4,4,0,0,0,0
2264830,3,1,1,2,-1,1,0,0
2266571,1,1,7,6,1,0,1,1
2266571,2,1,0,0,0,0,0,0
2267338,1,1,0,0,0,0,0,0
2267338,2,1,0,0,0,0,0,0
2267804,1,1,4,4,0,0,0,0
2267804,2,1,2,2,0,0,0,0
2268045,1,1,5,5,0,0,0,0
2268045,2,1,2,2,0,0,0,0
2269840,1,1,3,2,1,0,1,0
2281511,1,1,5,4,1,0,1,1
2281511,2,1,0,0,0,0,0,0
2281511,3,1,0,0,0,0,0,0
2291208,1,1,10,6,4,0,4,4
2291208,2,1,6,6,0,0,0,0
2295627,1,1,0,0,0,0,0,0
2483552,1,1,9,8,1,0,1,1
2487482,1,1,6,7,-1,1,0,0
2487482,2,1,4,4,0,0,0,0
2492506,1,1,5,5,0,0,0,0
2492506,2,1,4,4,0,0,0,0
2496311,1,1,4,4,0,0,0,0
2496311,2,1,2,2,0,0,0,0
2498788,1,1,3,4,-1,1,0,0
2500911,1,1,2,2,0,0,0,0
2500911,2,1,0,0,0,0,0,0
2510248,1,1,6,4,2,0,2,2
2510248,2,1,4,4,0,0,0,0
2513557,1,1,0,0,0,0,0,0
2513557,2,1,2,2,0,0,0,0
2514178,1,1,3,3,0,0,0,0
2514178,2,1,4,4,0,0,0,0
2517401,1,1,2,2,0,0,0,0
2517401,2,1,4,3,1,0,1,1
2518082,1,1,0,0,0,0,0,0
2518082,2,1,0,0,0,0,0,0
2518996,1,1,3,3,0,0,0,0
2518996,2,1,11,11,0,0,0,0
2518996,3,1,0,0,0,0,0,0
2525166,1,1,0,0,0,0,0,0
2525166,2,1,5,4,1,0,1,1
2525166,3,1,0,0,0,0,0,0
2526824,1,1,11,4,7,0,8,8
2526824,2,1,5,2,3,0,3,3
2527998,2,1,10,8,2,0,2,2
2527998,3,1,0,0,0,0,0,0
2537814,1,1,5,5,0,0,0,0
2537814,2,1,0,0,0,0,0,0
2538023,1,1,18,9,9,0,9,9
2550511,1,1,2,2,0,0,0,0
2552032,1,1,4,4,0,0,0,0
2552032,2,1,5,4,1,0,1,1
2552032,3,1,5,5,0,0,0,0
2552758,1,1,8,4,4,0,4,3
2552758,2,1,2,2,0,0,0,0
2552832,1,1,0,0,0,0,0,0
2552832,2,1,8,7,1,3,4,4
2555550,1,1,6,6,0,0,0,0
2555550,2,1,3,2,1,0,1,1
2556033,1,1,4,3,1,0,1,1
2556033,2,1,4,5,-1,1,0,0
2557083,1,1,8,9,-1,5,4,3
2561298,1,1,10,7,3,0,3,3
2562300,1,1,5,5,0,0,0,0
2564708,1,1,4,4,0,0,0,0
2569231,1,1,2,2,0,0,0,0
2569231,2,1,6,6,0,0,0,0
2569979,1,1,0,0,0,0,0,0
2569979,2,1,3,2,1,0,1,1
2572796,1,1,8,4,4,1,5,5
2572796,2,1,7,2,5,0,5,5
2572796,3,1,5,3,2,1,3,3
2576463,1,1,3,3,0,0,0,0
2576463,2,1,0,0,0,0,0,0
2576484,1,1,8,4,4,0,4,3
2577440,1,1,0,0,0,0,0,0
2577440,2,1,4,5,-1,1,0,0
2578322,1,1,2,2,0,0,0,0
2578322,2,1,3,3,0,0,0,0
2581661,1,1,0,0,0,0,0,0
2581661,2,1,0,0,0,0,0,0
2588463,1,1,0,0,0,0,0,0
2588463,2,1,9,9,0,4,0,0
2592356,1,1,5,5,0,0,0,0
2592356,2,1,0,0,0,0,0,0
2592356,3,1,4,3,1,0,1,0
2594688,1,1,6,5,1,0,1,1
2594688,2,1,7,6,1,0,1,1
2597985,1,1,11,11,0,0,0,0
2601214,1,1,4,4,0,0,0,0
2601214,2,1,2,2,0,0,0,0
2609398,1,1,2,9,-7,7,0,0
2611413,1,1,6,4,2,0,2,2
2611413,2,1,4,3,1,0,1,1
2611413,3,1,5,5,0,0,0,0
2614633,1,1,4,2,2,0,2,2
2621146,1,1,2,2,0,0,0,0
2621146,2,1,4,4,0,0,0,0
2626517,1,1,7,7,0,0,0,0
2638244,1,1,17,14,3,0,3,3
2638244,2,1,3,2,1,0,1,1
2643323,1,1,6,6,0,0,0,0
2643742,1,1,3,2,1,0,1,1
2643742,2,1,8,7,1,0,1,1
2643778,1,1,4,3,1,1,2,2
2643945,1,1,5,6,-1,3,2,2
2643945,2,1,5,3,2,0,2,2
2645047,1,1,6,3,3,0,3,2
2645047,2,1,8,4,4,0,4,3
2645047,3,1,0,0,0,0,0,0
2646999,1,1,18,10,8,0,8,8
2646999,2,1,0,0,0,0,0,0
2647188,1,1,11,8,3,0,3,3
2647188,2,1,8,6,2,0,2,2
2649003,1,1,7,6,1,0,1,1
2649003,2,1,2,6,-4,4,0,0
2650170,1,1,2,5,-3,3,0,0
2650170,2,1,11,7,4,0,4,4
2652089,1,1,3,3,0,0,0,0
2652089,2,1,6,5,1,0,1,1
2653286,1,1,11,8,3,0,3,2
2653286,2,1,0,0,0,0,0,0
2654851,1,1,8,8,0,0,0,0
2654851,3,1,3,3,0,0,0,0
2654878,1,1,4,4,0,0,0,0
2654878,2,1,0,0,0,0,0,0
2654878,3,1,0,0,0,0,0,0
2655433,1,1,3,2,1,0,1,1
2655433,2,1,2,2,0,0,0,0
2656998,1,1,2,2,0,0,0,0
2656998,2,1,0,0,0,0,0,0
2658298,1,1,8,8,0,0,0,0
2658298,2,1,7,7,0,0,0,0
2661241,1,1,0,0,0,0,0,0
2661241,2,1,0,0,0,0,0,0
2662005,1,1,7,4,3,0,3,3
2665232,1,1,4,3,1,0,1,1
2697790,1,1,8,8,0,0,0,0
2697790,2,1,6,4,2,0,2,2
2718575,1,1,0,0,0,0,0,0
2720349,1,1,0,0,0,0,0,0
2720349,2,1,0,0,0,0,0,0
2720349,3,1,0,0,0,0,0,0
2741339,1,1,5,5,0,0,0,0
2741339,2,1,3,3,0,0,0,0
2758999,1,1,5,4,1,0,1,1
2758999,2,1,0,0,0,0,0,0
2759536,1,1,2,2,0,0,0,0
2759536,3,1,5,5,0,0,0,0
2783063,1,1,3,3,0,0,0,0
2826327,1,1,8,8,0,2,2,2
2925637,1,1,6,6,0,0,0,0
2925637,2,1,3,3,0,0,0,0
2926552,1,1,0,0,0,0,0,0
2926552,2,1,3,2,1,0,1,1
2926552,3,1,4,4,0,0,0,0
2943742,1,1,4,3,1,0,1,1
2943742,2,1,0,0,0,0,0,0
2943742,3,1,0,0,0,0,0,0
2949525,1,1,0,0,0,0,0,0
2949525,2,1,0,0,0,0,0,0
2951975,1,1,5,5,0,0,0,0
2951975,2,1,4,2,2,0,2,2
2953058,1,1,0,0,0,0,0,0
2953058,2,1,0,0,0,0,0,0
2954351,1,1,5,3,2,0,2,2
2954351,2,1,2,2,0,0,0,0
2954351,3,1,11,7,4,0,4,4
2957153,1,1,2,2,0,0,0,0
2957153,2,1,2,2,0,0,0,0
2959995,1,1,3,3,0,0,0,0
2959995,2,1,0,0,0,0,0,0
2964861,1,1,7,7,0,0,0,0
2967627,1,1,0,0,0,0,0,0
2967627,2,1,5,4,1,0,1,1
3022385,1,1,0,0,0,0,0,0
3022385,2,1,2,2,0,0,0,0
3029527,1,1,3,4,-1,1,0,0
3029527,2,1,2,2,0,0,0,0
3029751,1,1,0,0,0,0,0,0
3029751,2,1,0,0,0,0,0,0
3039701,1,1,5,3,2,0,2,2
3052193,1,1,2,2,0,0,0,0
3052193,2,1,1,1,0,0,0,0
3052193,3,1,3,4,-1,2,1,1
3068067,1,1,0,0,0,0,0,0
3068067,2,1,0,0,0,0,0,0
3069471,1,1,0,0,0,0,0,0
3069471,2,1,0,0,0,0,0,0
7200837,1,1,0,0,0,0,0,0
7200837,2,1,0,0,0,0,0,0
7201245,1,1,2,2,0,0,0,0
7201245,2,1,4,4,0,0,0,0
7202124,3,1,3,3,0,0,0,0
7202261,1,1,8,8,0,0,0,0
7202387,1,1,5,2,3,1,4,4
7202838,1,1,3,3,0,0,0,0
7203018,2,1,0,0,0,0,0,0
7203018,3,1,0,0,0,0,0,0
7203094,1,1,5,2,3,1,4,4
7203094,2,1,0,0,0,0,0,0
7203374,1,1,0,0,0,0,0,0
7203374,2,1,7,4,3,0,3,1
7203525,1,1,0,0,0,0,0,0
7203525,2,1,0,0,0,0,0,0
7203896,1,1,3,3,0,0,0,0
7203896,2,1,0,0,0,0,0,0
7204105,1,1,15,14,1,0,1,1
7204105,2,1,0,0,0,0,0,0
7204239,1,1,4,4,0,0,0,0
7204239,2,1,12,6,6,1,7,7
7204286,1,1,9,5,4,0,4,3
7209067,2,1,3,6,-3,4,1,1
7209067,3,1,0,0,0,0,0,0
7212324,1,1,0,0,0,0,0,0
7212324,2,1,0,0,0,0,0,0
7212324,3,1,0,0,0,0,0,0
