sampno,perno,gpsdiarycomplete,nbgpstripsdiaryday,nbdiaryreportedtrips,rawmatchdifference,nbmissinggpstrips,nbmissingdiarytrips,nbadjustedmissdiary
1041494,1,1,0,0,0,0,0,0
1041494,2,1,0,0,0,0,0,0
1041494,3,1,0,0,0,0,0,0
1043613,1,1,6,6,0,0,0,0
1043613,2,1,6,5,1,1,2,1
1048852,1,1,16,18,-2,3,1,1
1050385,1,1,3,4,-1,2,1,1
1052905,1,1,9,9,0,0,0,0
1055449,1,1,5,2,3,0,3,3
1055449,2,1,7,4,3,1,4,4
1059276,1,1,16,9,7,3,10,8
1065589,1,1,3,2,1,0,1,0
1065589,2,1,2,2,0,0,0,0
1066541,1,1,5,5,0,0,0,0
1066541,2,1,8,4,4,0,4,4
1119021,1,1,0,0,0,0,0,0
1119021,2,1,0,0,0,0,0,0
1119035,1,1,6,4,2,0,2,2
1119040,1,1,2,2,0,0,0,0
1119762,1,1,6,5,1,0,1,1
1119993,1,1,12,11,1,2,3,3
1119993,2,1,11,9,2,3,5,5
1120119,1,1,6,6,0,0,0,0
1120231,1,1,5,4,1,0,1,1
1120697,1,1,11,9,2,0,2,2
1120697,2,1,0,0,0,0,0,0
1121125,1,1,8,8,0,1,1,0
1121261,1,1,9,7,2,0,2,2
1121261,2,1,3,3,0,0,0,0
1121263,1,1,10,9,1,1,2,1
1121263,2,1,6,4,2,0,2,0
1121310,1,1,2,5,-3,3,0,0
1121310,2,1,5,5,0,0,0,0
1121448,1,1,2,2,0,0,0,0
1121448,2,1,5,5,0,0,0,0
1121448,3,1,3,4,-1,1,0,0
1121606,1,1,13,12,1,0,1,1
1121606,2,1,6,6,0,0,0,0
1121694,1,1,6,2,4,0,4,4
1121694,2,1,2,2,0,0,0,0
1121752,1,1,8,7,1,0,1,1
1121752,2,1,15,8,7,0,7,3
1123124,3,1,18,7,11,1,12,9
1123197,1,1,5,6,-1,2,1,0
1123197,3,1,3,3,0,0,0,0
1123197,4,1,6,3,3,0,3,3
1123587,1,1,5,8,-3,3,0,0
1123587,2,1,9,9,0,0,0,0
1123731,1,1,5,5,0,0,0,0
1123731,3,1,8,8,0,0,0,0
1123731,4,1,7,5,2,2,4,4
1124202,1,1,12,10,2,1,3,3
1124202,2,1,9,10,-1,4,3,0
1124202,3,1,1,8,-7,7,0,0
1124315,1,1,4,4,0,0,0,0
1124362,1,1,0,0,0,0,0,0
1124474,1,1,3,3,0,0,0,0
1124474,2,1,5,6,-1,2,1,1
1124769,1,1,12,9,3,1,4,4
1124769,2,1,0,0,0,0,0,0
1124769,3,1,10,6,4,0,4,0
1125257,2,1,13,6,7,0,7,3
1125309,1,1,5,2,3,0,3,1
1125309,2,1,35,2,33,0,33,2
1125309,3,1,11,8,3,0,3,3
1125492,1,1,6,5,1,1,2,1
1125492,2,1,2,5,-3,3,0,0
1125492,3,1,10,5,5,0,5,3
1125843,1,1,2,4,-2,2,0,0
1125843,2,1,4,5,-1,2,1,1
1125937,1,1,2,2,0,1,1,0
1125937,2,1,3,2,1,0,1,0
1125964,1,1,4,3,1,0,1,1
1126014,1,1,3,3,0,0,0,0
1126396,1,1,0,0,0,0,0,0
1126853,1,1,10,10,0,2,2,2
1126853,2,1,9,8,1,2,3,1
1126968,1,1,1,0,1,0,1,0
1126968,2,1,0,0,0,0,0,0
1126992,1,1,9,9,0,0,0,0
1127272,1,1,6,2,4,0,4,4
1127272,2,1,9,5,4,0,4,4
1127481,1,1,5,5,0,0,0,0
1127481,2,1,19,6,13,0,13,2
1127626,1,1,13,11,2,1,3,2
1127626,2,1,13,13,0,0,0,0
1127843,1,1,4,4,0,0,0,0
1127843,2,1,5,3,2,0,2,2
1128205,1,1,3,6,-3,3,0,0
1128205,2,1,7,5,2,1,3,3
1128205,3,1,3,2,1,1,2,2
1129139,1,1,6,5,1,0,1,0
1129697,1,1,0,0,0,0,0,0
1129862,1,1,9,3,6,0,6,5
1129862,2,1,5,3,2,0,2,2
1129862,4,1,0,0,0,0,0,0
1130076,1,1,9,8,1,0,1,1
1130076,2,1,4,3,1,0,1,1
1130977,1,1,7,6,1,0,1,1
1131308,1,1,3,2,1,0,1,1
1131308,3,1,4,2,2,0,2,2
1131380,1,1,9,9,0,0,0,0
1131380,2,1,1,5,-4,4,0,0
1131380,3,1,0,0,0,0,0,0
1131529,1,1,12,10,2,0,2,1
1131529,2,1,10,9,1,0,1,1
1131529,3,1,12,5,7,1,8,0
1131592,1,1,0,0,0,0,0,0
1132119,1,1,7,8,-1,2,1,1
1132139,1,1,9,9,0,0,0,0
1132139,2,1,3,4,-1,1,0,0
1132210,1,1,4,5,-1,1,0,0
1132210,2,1,0,0,0,0,0,0
1132468,1,1,9,7,2,0,2,2
1132468,2,1,21,2,19,0,19,1
1132741,1,1,6,6,0,0,0,0
1132741,2,1,2,4,-2,2,0,0
1132759,1,1,9,6,3,0,3,3
1132759,2,1,5,3,2,0,2,1
1132890,1,1,3,6,-3,3,0,0
1132890,2,1,5,7,-2,2,0,0
1133036,1,1,6,5,1,0,1,1
1133036,2,1,8,12,-4,5,1,1
1133154,1,1,2,4,-2,2,0,0
1133154,2,1,0,0,0,0,0,0
1133154,3,1,2,6,-4,4,0,0
1133746,1,1,0,0,0,0,0,0
1133746,2,1,5,2,3,0,3,3
1133746,3,1,0,0,0,0,0,0
1133746,4,1,0,0,0,0,0,0
1133746,5,1,3,1,2,0,2,2
1134113,1,1,2,2,0,0,0,0
1134135,1,1,3,2,1,0,1,0
1134135,2,1,7,6,1,2,3,2
1134394,1,1,0,0,0,0,0,0
1134860,1,1,0,0,0,0,0,0
1134890,1,1,7,3,4,0,4,3
1134890,2,1,7,3,4,0,4,3
1134890,3,1,8,3,5,0,5,5
1134890,5,1,2,2,0,0,0,0
1134890,6,1,2,4,-2,2,0,0
1135117,1,1,4,4,0,0,0,0
1135117,2,1,4,2,2,0,2,2
1135291,1,1,4,3,1,0,1,0
1135291,2,1,4,3,1,1,2,1
1135478,1,1,6,4,2,0,2,2
1135630,1,1,5,6,-1,1,0,0
1135876,1,1,2,2,0,0,0,0
1135876,2,1,0,0,0,0,0,0
1135906,1,1,1,11,-10,10,0,0
1135906,2,1,5,3,2,0,2,0
1135920,1,1,0,0,0,0,0,0
1135976,1,1,4,5,-1,1,0,0
1135976,2,1,4,2,2,0,2,2
1136102,1,1,8,8,0,0,0,0
1136119,1,1,0,0,0,0,0,0
1136119,2,1,4,4,0,0,0,0
1136119,3,1,5,2,3,0,3,3
1136370,1,1,16,9,7,1,8,4
1136370,2,1,9,7,2,0,2,2
1136407,1,1,0,0,0,0,0,0
1136407,2,1,3,4,-1,1,0,0
1136853,1,1,0,0,0,0,0,0
1136853,2,1,0,0,0,0,0,0
1136989,1,1,9,7,2,0,2,2
1136989,2,1,7,7,0,0,0,0
1137373,1,1,1,1,0,0,0,0
1137373,2,1,6,2,4,0,4,1
1137381,1,1,0,0,0,0,0,0
1137381,2,1,8,6,2,0,2,2
1137895,1,1,6,5,1,2,3,2
1137895,2,1,3,6,-3,3,0,0
1137895,3,1,3,2,1,0,1,1
1138127,1,1,7,4,3,0,3,0
1138323,1,1,4,2,2,0,2,2
1138323,2,1,5,6,-1,1,0,0
1138391,1,1,5,1,4,0,4,4
1138391,2,1,0,0,0,0,0,0
1138686,1,1,9,8,1,2,3,2
1138707,1,1,10,9,1,0,1,1
1138798,1,1,5,3,2,0,2,2
1138798,2,1,0,0,0,0,0,0
1139208,1,1,4,4,0,0,0,0
1139254,1,1,0,0,0,0,0,0
1139254,2,1,0,0,0,0,0,0
1139514,1,1,12,8,4,6,10,0
1139514,2,1,3,4,-1,1,0,0
1139845,1,1,3,3,0,0,0,0
1139845,2,1,4,2,2,0,2,2
1139913,1,1,3,3,0,0,0,0
1140147,1,1,8,5,3,0,3,2
1140227,1,1,16,3,13,1,14,0
1140514,1,1,10,8,2,0,2,2
1140514,2,1,4,6,-2,2,0,0
1140730,2,1,9,5,4,0,4,1
1140730,3,1,5,3,2,0,2,2
1140730,4,1,3,2,1,0,1,0
1140730,5,1,12,6,6,0,6,3
1141077,1,1,0,0,0,0,0,0
1141077,2,1,0,0,0,0,0,0
1141185,1,1,14,7,7,1,8,8
1141185,2,1,11,4,7,0,7,7
1141648,1,1,3,3,0,0,0,0
1141648,2,1,0,0,0,0,0,0
1141686,1,1,9,7,2,0,2,2
1141686,2,1,2,2,0,0,0,0
1142029,1,1,4,4,0,0,0,0
1142029,2,1,1,4,-3,3,0,0
1142612,1,1,5,4,1,0,1,1
1142612,2,1,5,4,1,0,1,1
1142701,1,1,5,5,0,0,0,0
1142701,2,1,5,7,-2,3,1,0
1142701,3,1,8,7,1,0,1,0
1142789,1,1,5,7,-2,3,1,1
1143233,1,1,4,5,-1,2,1,1
1143233,2,1,4,4,0,0,0,0
1143505,1,1,6,6,0,0,0,0
1143505,2,1,10,9,1,0,1,1
1143740,1,1,6,6,0,0,0,0
1143814,1,1,0,0,0,0,0,0
1143814,2,1,0,0,0,0,0,0
1145194,1,1,4,6,-2,2,0,0
1145194,2,1,5,8,-3,4,1,1
1145353,1,1,2,6,-4,4,0,0
1145588,1,1,2,3,-1,1,0,0
1145588,2,1,5,5,0,0,0,0
1147026,1,1,6,1,5,0,5,5
1147026,3,1,0,0,0,0,0,0
1147026,7,1,0,0,0,0,0,0
1147833,1,1,5,13,-8,9,1,0
1147833,2,1,14,10,4,1,5,3
1148086,1,1,6,4,2,0,2,2
1148453,1,1,11,10,1,1,2,1
1148899,1,1,12,8,4,0,4,3
1148899,2,1,0,0,0,0,0,0
1148962,1,1,0,0,0,0,0,0
1149029,1,1,2,7,-5,5,0,0
1149029,2,1,8,8,0,3,3,2
1149029,3,1,0,0,0,0,0,0
1149981,1,1,5,5,0,0,0,0
1149981,2,1,13,12,1,0,1,0
1150090,1,1,10,9,1,0,1,1
1150090,2,1,16,12,4,0,4,4
1150277,1,1,13,5,8,0,8,8
1150298,1,1,9,8,1,0,1,1
1150298,2,1,24,16,8,2,10,10
1150298,3,1,9,2,7,0,7,7
1150298,4,1,18,14,4,0,4,4
1150646,1,1,4,4,0,1,1,0
1150835,1,1,7,9,-2,4,2,1
1151272,2,1,2,2,0,0,0,0
1151272,3,1,4,2,2,0,2,2
1151647,1,1,2,2,0,0,0,0
1151647,2,1,6,6,0,0,0,0
1152715,1,1,0,0,0,0,0,0
1152715,2,1,0,0,0,0,0,0
1152715,3,1,0,0,0,0,0,0
1152854,1,1,6,6,0,2,2,2
1153183,1,1,2,2,0,0,0,0
1153183,2,1,6,2,4,0,4,3
1153453,1,1,7,7,0,0,0,0
1153453,2,1,12,8,4,0,4,1
1153616,1,1,6,4,2,0,2,2
1153616,2,1,12,10,2,0,2,0
1153616,3,1,0,0,0,0,0,0
1153616,4,1,10,8,2,1,3,0
1154699,1,1,0,0,0,0,0,0
1155258,1,1,6,6,0,0,0,0
1155258,2,1,4,3,1,0,1,0
1155425,1,1,7,7,0,0,0,0
1155425,2,1,5,4,1,2,3,3
1155425,3,1,2,2,0,0,0,0
1155767,1,1,2,2,0,0,0,0
1155767,2,1,10,10,0,4,4,1
1156030,1,1,0,0,0,0,0,0
1156030,2,1,0,0,0,0,0,0
1156555,1,1,2,2,0,0,0,0
1156555,2,1,5,4,1,0,1,0
1157090,1,1,9,7,2,0,2,1
1157763,1,1,5,4,1,0,1,1
1158177,1,1,0,0,0,0,0,0
1158177,2,1,0,0,0,0,0,0
1158177,3,1,0,0,0,0,0,0
1158255,1,1,6,6,0,2,2,1
1158255,2,1,4,6,-2,2,0,0
1158841,1,1,4,5,-1,1,0,0
1158841,2,1,8,6,2,0,2,2
1159400,1,1,6,4,2,0,2,2
1160166,1,1,4,4,0,0,0,0
1160166,2,1,4,2,2,0,2,2
1160166,3,1,0,0,0,0,0,0
1160182,1,1,0,0,0,0,0,0
1160240,1,1,8,8,0,0,0,0
1160240,2,1,9,9,0,0,0,0
1160945,1,1,5,5,0,0,0,0
1160945,2,1,4,5,-1,1,0,0
1161045,1,1,6,7,-1,1,0,0
1161045,2,1,5,7,-2,3,1,0
1161045,3,1,0,0,0,0,0,0
1161710,1,1,0,0,0,0,0,0
1161987,1,1,7,9,-2,2,0,0
1161987,2,1,16,10,6,0,6,0
1162368,1,1,5,5,0,0,0,0
1162368,2,1,3,3,0,0,0,0
1162368,3,1,5,2,3,0,3,1
1162672,1,1,0,0,0,0,0,0
1162672,2,1,0,0,0,0,0,0
1162704,1,1,1,6,-5,5,0,0
1162704,2,1,5,2,3,0,3,3
1162757,1,1,13,12,1,1,2,2
1162757,2,1,12,12,0,1,1,1
1162978,1,1,13,10,3,1,4,4
1163204,1,1,5,5,0,0,0,0
1163726,1,1,6,6,0,0,0,0
1163961,1,1,4,4,0,0,0,0
1163961,2,1,8,7,1,0,1,1
1164027,1,1,3,3,0,0,0,0
1164027,2,1,0,0,0,0,0,0
1164052,1,1,15,14,1,1,2,2
1164052,2,1,6,7,-1,1,0,0
1164304,2,1,14,10,4,0,4,3
1164369,1,1,14,12,2,0,2,2
1164665,1,1,21,7,14,2,16,1
1165464,1,1,4,9,-5,7,2,1
1166231,1,1,4,2,2,0,2,2
1166231,2,1,8,3,5,0,5,1
1166231,3,1,9,3,6,0,6,2
1166359,1,1,4,3,1,1,2,1
1166359,2,1,2,2,0,0,0,0
1166704,1,1,9,9,0,0,0,0
1167406,1,1,12,9,3,0,3,2
1168201,1,1,0,0,0,0,0,0
1168201,2,1,2,2,0,0,0,0
1168555,1,1,0,0,0,0,0,0
1168673,1,1,8,4,4,1,5,0
1168906,1,1,5,9,-4,4,0,0
1168906,2,1,2,2,0,0,0,0
1168906,3,1,4,4,0,0,0,0
1169219,1,1,6,8,-2,2,0,0
1169372,1,1,2,2,0,0,0,0
1169372,2,1,4,2,2,1,3,3
1169868,1,1,4,4,0,0,0,0
1169868,2,1,7,7,0,0,0,0
1169868,3,1,23,11,12,0,12,7
1170324,1,1,10,9,1,0,1,1
1170324,2,1,4,3,1,0,1,0
1170324,3,1,10,3,7,0,7,4
1170470,1,1,8,8,0,0,0,0
1170713,1,1,2,3,-1,1,0,0
1170713,2,1,5,2,3,0,3,3
1170713,3,1,7,3,4,0,4,1
1170729,1,1,3,4,-1,1,0,0
1171106,1,1,0,0,0,0,0,0
1172202,1,1,4,4,0,2,2,2
1172202,2,1,4,12,-8,8,0,0
1172515,1,1,5,5,0,0,0,0
1172515,2,1,5,10,-5,5,0,0
1172515,4,1,13,5,8,0,8,8
1172515,5,1,10,9,1,0,1,0
1172515,6,1,13,6,7,0,7,0
1172549,1,1,9,6,3,0,3,2
1172549,2,1,7,7,0,0,0,0
1172549,3,1,0,0,0,0,0,0
1172549,4,1,7,6,1,0,1,1
1172549,5,1,2,7,-5,5,0,0
1172716,1,1,0,0,0,0,0,0
1172814,1,1,4,6,-2,2,0,0
1172814,2,1,9,7,2,0,2,1
1172814,3,1,6,6,0,0,0,0
1172814,4,1,6,6,0,0,0,0
1172894,1,1,5,5,0,0,0,0
1172894,2,1,5,5,0,0,0,0
1172957,1,1,7,7,0,0,0,0
1172957,2,1,3,6,-3,3,0,0
1173157,1,1,8,6,2,0,2,2
1173157,2,1,5,4,1,0,1,1
1173654,1,1,7,9,-2,3,1,1
1173654,2,1,4,7,-3,3,0,0
1173669,1,1,2,2,0,0,0,0
1173669,2,1,3,2,1,0,1,1
1174276,1,1,7,7,0,0,0,0
1176798,1,1,7,6,1,0,1,1
1176798,2,1,4,4,0,0,0,0
1176804,1,1,6,6,0,0,0,0
1176804,2,1,4,4,0,0,0,0
1177174,1,1,4,4,0,0,0,0
1177174,2,1,0,0,0,0,0,0
1177229,1,1,6,6,0,0,0,0
1177229,2,1,4,5,-1,1,0,0
1177333,1,1,6,2,4,0,4,4
1177333,2,1,0,0,0,0,0,0
1178677,1,1,4,6,-2,3,1,0
1178677,2,1,5,8,-3,3,0,0
1179431,1,1,2,2,0,0,0,0
1179431,2,1,0,0,0,0,0,0
1179438,1,1,3,3,0,0,0,0
1179438,2,1,6,6,0,0,0,0
1179615,1,1,4,8,-4,4,0,0
1179615,2,1,8,7,1,0,1,1
1180223,1,1,7,9,-2,4,2,2
1180223,2,1,3,5,-2,2,0,0
1180223,3,1,2,2,0,0,0,0
1180392,1,1,11,13,-2,2,0,0
1180392,2,1,11,11,0,0,0,0
1182950,1,1,1,6,-5,5,0,0
1183122,1,1,0,0,0,0,0,0
1183122,2,1,0,0,0,0,0,0
1183722,1,1,9,8,1,0,1,0
1183722,2,1,12,12,0,0,0,0
1185125,1,1,0,0,0,0,0,0
1185125,2,1,2,2,0,0,0,0
1185196,1,1,7,7,0,0,0,0
1185393,1,1,7,5,2,0,2,1
1185817,1,1,6,4,2,0,2,2
1186189,1,1,6,5,1,0,1,1
1186189,2,1,5,4,1,0,1,1
1186575,1,1,5,5,0,0,0,0
1186575,2,1,2,2,0,0,0,0
1187427,1,1,8,14,-6,6,0,0
1187427,4,1,7,11,-4,4,0,0
1188614,1,1,10,5,5,0,5,5
1188614,2,1,16,6,10,0,10,2
1188930,1,1,4,2,2,0,2,0
1189565,1,1,6,6,0,0,0,0
1189565,2,1,3,3,0,0,0,0
1191381,1,1,7,5,2,0,2,2
1191381,2,1,18,33,-15,17,2,2
1197357,1,1,6,4,2,0,2,0
1197925,1,1,4,3,1,0,1,0
1198330,1,1,11,7,4,0,4,4
1198330,2,1,10,7,3,0,3,3
1198330,3,1,0,0,0,0,0,0
1198330,4,1,6,7,-1,3,2,0
1201267,1,1,7,6,1,2,3,3
1201267,2,1,4,7,-3,4,1,1
1201267,3,1,3,4,-1,2,1,1
1203420,1,1,14,11,3,0,3,3
1203420,2,1,0,0,0,0,0,0
1205585,1,1,6,5,1,0,1,0
1205894,1,1,6,6,0,0,0,0
1205894,2,1,2,2,0,0,0,0
1206840,1,1,2,2,0,0,0,0
1206840,2,1,15,4,11,0,11,0
1206849,1,1,8,8,0,0,0,0
1206849,2,1,6,7,-1,2,1,0
1209104,1,1,5,4,1,0,1,1
1209104,2,1,5,4,1,0,1,1
1216320,1,1,7,7,0,0,0,0
1216320,2,1,6,6,0,0,0,0
1216919,1,1,2,2,0,1,1,1
1217174,1,1,4,4,0,0,0,0
1220620,1,1,0,0,0,0,0,0
1221265,1,1,0,0,0,0,0,0
1221265,2,1,12,8,4,0,4,4
1221265,3,1,0,0,0,0,0,0
1221265,4,1,0,0,0,0,0,0
1222333,1,1,6,6,0,0,0,0
1222333,2,1,5,4,1,0,1,1
1223485,1,1,6,6,0,0,0,0
1224553,1,1,7,10,-3,4,1,1
1224553,2,1,5,8,-3,4,1,1
1227677,1,1,2,2,0,0,0,0
1234445,1,1,0,0,0,0,0,0
1234445,2,1,4,4,0,0,0,0
1237062,1,1,3,4,-1,1,0,0
1237062,2,1,4,4,0,1,1,1
1237062,3,1,5,5,0,0,0,0
1237062,4,1,2,2,0,0,0,0
1238063,1,1,12,7,5,0,5,1
1238063,2,1,11,11,0,0,0,0
1238063,3,1,6,6,0,0,0,0
1238063,5,1,0,0,0,0,0,0
1238891,1,1,7,6,1,0,1,1
1238891,2,1,5,6,-1,2,1,1
1238891,3,1,0,0,0,0,0,0
1238891,4,1,1,4,-3,3,0,0
1238891,5,1,4,2,2,0,2,2
1238983,1,1,4,4,0,0,0,0
1238983,2,1,0,0,0,0,0,0
1240215,1,1,3,3,0,1,1,0
1240215,2,1,3,3,0,0,0,0
1242289,1,1,5,5,0,0,0,0
1243366,1,1,3,2,1,0,1,1
1243917,1,1,5,4,1,0,1,1
1244338,1,1,5,8,-3,3,0,0
1244338,2,1,4,4,0,0,0,0
1251980,1,1,10,6,4,0,4,3
1251980,2,1,2,2,0,0,0,0
1253990,1,1,3,3,0,0,0,0
1253990,2,1,2,4,-2,2,0,0
1254545,1,1,5,6,-1,1,0,0
1254545,2,1,4,2,2,0,2,2
1257772,1,1,6,6,0,0,0,0
1257772,2,1,0,0,0,0,0,0
1257772,3,1,14,12,2,0,2,2
1257772,4,1,0,0,0,0,0,0
1257772,5,1,2,2,0,0,0,0
1257772,6,1,14,10,4,1,5,5
1257772,7,1,5,7,-2,3,1,1
1257772,8,1,3,3,0,0,0,0
1260078,1,1,0,0,0,0,0,0
1263576,1,1,3,2,1,0,1,1
1263576,2,1,15,10,5,1,6,4
1264022,1,1,3,3,0,0,0,0
1264022,2,1,7,5,2,0,2,2
1265445,1,1,3,9,-6,6,0,0
1265445,2,1,3,3,0,0,0,0
1265445,3,1,8,4,4,0,4,0
1265784,1,1,6,6,0,0,0,0
1269131,1,1,6,6,0,0,0,0
1269131,2,1,4,4,0,0,0,0
1269231,1,1,6,6,0,0,0,0
1269231,2,1,9,10,-1,1,0,0
1271336,1,1,6,5,1,0,1,0
1271462,1,1,5,7,-2,4,2,1
1271462,2,1,10,7,3,0,3,3
1271889,1,1,0,0,0,0,0,0
1271889,2,1,0,0,0,0,0,0
1272227,1,1,6,0,6,0,6,0
1272227,2,1,8,10,-2,2,0,0
1276395,1,1,2,2,0,0,0,0
1276395,2,1,2,2,0,0,0,0
1277787,1,1,6,6,0,0,0,0
1278210,1,1,0,0,0,0,0,0
1278210,2,1,9,7,2,0,2,1
1278276,1,1,3,2,1,0,1,1
1281468,1,1,5,4,1,0,1,0
1281468,2,1,5,4,1,0,1,0
1286478,1,1,13,9,4,0,4,4
1286478,2,1,11,7,4,0,4,4
1288207,1,1,7,7,0,0,0,0
1288207,2,1,10,7,3,0,3,2
1288207,3,1,2,2,0,0,0,0
1288616,2,1,5,4,1,0,1,0
1289586,1,1,2,2,0,0,0,0
1295487,1,1,0,0,0,0,0,0
1295919,1,1,7,3,4,0,4,2
1295919,2,1,13,7,6,0,6,1
1296011,1,1,7,7,0,0,0,0
1296011,2,1,26,2,24,0,24,0
1297587,1,1,13,9,4,0,4,4
1297587,2,1,2,2,0,0,0,0
1298797,1,1,4,3,1,0,1,1
1298797,2,1,4,3,1,0,1,1
1300089,1,1,7,6,1,1,2,2
1300089,2,1,9,6,3,0,3,3
1300089,3,1,6,2,4,0,4,4
1300642,1,1,2,8,-6,6,0,0
1300991,1,1,13,12,1,1,2,2
1300991,2,1,4,4,0,0,0,0
1302033,1,1,3,2,1,0,1,1
1302033,2,1,5,4,1,0,1,1
1305092,1,1,10,9,1,0,1,0
1305092,2,1,0,0,0,0,0,0
1307522,1,1,5,5,0,0,0,0
1307983,1,1,8,7,1,0,1,0
1310704,1,1,12,12,0,0,0,0
1311356,1,1,11,9,2,0,2,2
1311859,1,1,8,8,0,0,0,0
1311859,2,1,8,8,0,0,0,0
1311989,1,1,3,3,0,0,0,0
1313043,1,1,6,5,1,0,1,1
1313043,2,1,8,6,2,2,4,4
1313096,1,1,0,0,0,0,0,0
1313096,2,1,11,9,2,0,2,1
1313593,1,1,6,6,0,0,0,0
1313593,2,1,10,9,1,0,1,1
1313997,1,1,5,6,-1,1,0,0
1313997,2,1,5,3,2,0,2,2
1314069,1,1,4,2,2,0,2,2
1314069,2,1,7,7,0,0,0,0
1314866,1,1,0,0,0,0,0,0
1314866,2,1,0,0,0,0,0,0
1315280,1,1,6,6,0,1,1,0
1315280,2,1,5,3,2,0,2,1
1315724,1,1,11,10,1,0,1,1
1315724,2,1,4,4,0,0,0,0
1316785,1,1,5,4,1,0,1,0
1316785,2,1,5,4,1,0,1,0
1319753,1,1,2,2,0,0,0,0
1319753,2,1,11,6,5,0,5,5
1320526,1,1,10,6,4,0,4,3
1320792,1,1,8,2,6,0,6,6
1320953,1,1,17,7,10,0,10,6
1320953,2,1,4,4,0,0,0,0
1320953,3,1,11,3,8,1,9,3
1321010,1,1,0,0,0,0,0,0
1321587,1,1,6,5,1,0,1,0
1321587,2,1,6,5,1,0,1,0
1323368,1,1,6,6,0,1,1,0
1323368,2,1,5,3,2,0,2,2
1325403,1,1,8,4,4,0,4,0
1325403,2,1,9,4,5,0,5,0
1325686,1,1,1,2,-1,1,0,0
1325686,2,1,9,6,3,1,4,4
1327287,1,1,10,9,1,0,1,0
1327287,2,1,10,8,2,0,2,2
1328096,1,1,5,5,0,0,0,0
1328096,2,1,7,7,0,0,0,0
1328096,3,1,11,6,5,0,5,0
1328163,1,1,0,0,0,0,0,0
1328163,2,1,0,0,0,0,0,0
1329631,1,1,10,8,2,0,2,1
1331581,1,1,18,14,4,0,4,4
1331581,2,1,7,6,1,0,1,1
1336408,1,1,2,2,0,0,0,0
1336408,2,1,2,2,0,0,0,0
1338123,1,1,9,8,1,0,1,1
1338349,1,1,8,4,4,0,4,3
1338349,2,1,9,4,5,0,5,5
1338349,3,1,13,5,8,0,8,6
1338534,1,1,2,2,0,0,0,0
1338534,2,1,3,2,1,1,2,2
1339402,1,1,0,0,0,0,0,0
1339402,3,1,8,5,3,1,4,4
1339402,4,1,0,0,0,0,0,0
1339470,1,1,24,21,3,0,3,1
1339470,2,1,0,0,0,0,0,0
1339470,3,1,26,12,14,0,14,10
1340572,1,1,13,12,1,0,1,1
1340572,2,1,10,10,0,0,0,0
1342185,1,1,8,7,1,0,1,1
1342185,2,1,4,8,-4,5,1,1
1342643,2,1,16,15,1,0,1,1
1342643,3,1,6,5,1,0,1,0
1342997,1,1,4,3,1,0,1,1
1342997,2,1,0,0,0,0,0,0
1342997,3,1,11,7,4,0,4,3
1343322,1,1,5,4,1,0,1,1
1343322,2,1,7,7,0,0,0,0
1345717,1,1,15,2,13,0,13,13
1345717,2,1,0,0,0,0,0,0
1346828,1,1,9,7,2,0,2,1
1346828,2,1,1,0,1,0,1,0
1346828,3,1,7,7,0,0,0,0
1347308,1,1,5,4,1,0,1,0
1347308,2,1,9,8,1,0,1,1
1348467,1,1,15,10,5,2,7,4
1348723,1,1,0,0,0,0,0,0
1350362,1,1,4,4,0,0,0,0
1350362,2,1,15,17,-2,2,0,0
1350434,1,1,5,2,3,0,3,3
1350674,1,1,3,4,-1,1,0,0
1350674,2,1,4,7,-3,4,1,1
1350674,3,1,4,5,-1,2,1,1
1350674,4,1,2,4,-2,2,0,0
1350674,5,1,7,4,3,2,5,0
1351613,1,1,5,5,0,0,0,0
1351613,2,1,9,7,2,0,2,1
1351654,1,1,16,15,1,0,1,1
1351654,2,1,2,2,0,0,0,0
1352129,1,1,13,11,2,0,2,1
1352129,2,1,10,10,0,0,0,0
1354508,1,1,4,4,0,0,0,0
1360089,1,1,7,5,2,1,3,3
1360510,1,1,8,8,0,0,0,0
1360575,1,1,9,5,4,0,4,4
1360575,2,1,3,2,1,0,1,1
1360575,3,1,2,2,0,1,1,1
1361771,1,1,2,2,0,0,0,0
1361771,2,1,0,0,0,0,0,0
1361771,3,1,6,3,3,1,4,3
1362489,1,1,0,0,0,0,0,0
1362489,2,1,5,4,1,0,1,0
1362557,1,1,6,4,2,1,3,3
1362557,2,1,6,5,1,1,2,2
1362586,1,1,5,2,3,1,4,2
1365391,1,1,8,9,-1,1,0,0
1365391,2,1,3,2,1,0,1,1
1365391,3,1,5,6,-1,1,0,0
1365818,1,1,4,3,1,0,1,1
1365818,3,1,5,2,3,1,4,1
1366888,1,1,10,10,0,0,0,0
1366888,2,1,4,4,0,0,0,0
1368733,1,1,0,0,0,0,0,0
1368733,2,1,2,10,-8,8,0,0
1368802,1,1,0,0,0,0,0,0
1368802,2,1,3,2,1,0,1,1
1368802,3,1,3,4,-1,1,0,0
1368802,4,1,0,0,0,0,0,0
1370955,1,1,6,2,4,0,4,4
1370955,2,1,14,2,12,0,12,12
1371817,1,1,3,2,1,0,1,0
1371817,2,1,4,2,2,0,2,2
1371926,1,1,14,4,10,0,10,8
1371926,2,1,5,4,1,3,4,4
1372257,1,1,2,4,-2,2,0,0
1373302,1,1,10,4,6,0,6,6
1373302,2,1,0,0,0,0,0,0
1373616,1,1,10,9,1,0,1,1
1373616,2,1,2,3,-1,2,1,1
1373616,3,1,9,7,2,0,2,2
1373616,4,1,16,11,5,0,5,1
1373616,5,1,15,11,4,0,4,4
1377126,1,1,5,4,1,1,2,2
1377126,2,1,2,2,0,0,0,0
1377952,1,1,4,6,-2,2,0,0
1379449,1,1,6,4,2,0,2,2
1379781,1,1,4,11,-7,7,0,0
1379781,2,1,8,9,-1,1,0,0
1380172,1,1,6,8,-2,2,0,0
1380172,2,1,3,3,0,0,0,0
1380199,1,1,0,0,0,0,0,0
1380199,2,1,3,3,0,0,0,0
1381218,1,1,8,4,4,0,4,4
1381218,2,1,5,5,0,0,0,0
1381572,1,1,6,6,0,0,0,0
1381572,2,1,16,10,6,0,6,3
1381774,1,1,13,10,3,0,3,3
1381774,2,1,10,8,2,0,2,1
1381944,1,1,4,5,-1,1,0,0
1381944,2,1,3,5,-2,2,0,0
1382297,1,1,0,0,0,0,0,0
1382297,2,1,8,8,0,0,0,0
1382320,1,1,8,7,1,0,1,0
1382320,2,1,12,6,6,0,6,6
1382656,1,1,8,8,0,2,2,2
1382656,2,1,8,6,2,0,2,2
1382656,3,1,3,3,0,0,0,0
1382656,4,1,1,2,-1,1,0,0
1383582,1,1,9,6,3,0,3,3
1383582,2,1,5,8,-3,4,1,1
1383583,1,1,6,5,1,0,1,1
1383583,2,1,7,8,-1,1,0,0
1383583,3,1,7,8,-1,1,0,0
1383839,1,1,5,7,-2,2,0,0
1383839,2,1,10,10,0,0,0,0
1383853,1,1,3,7,-4,4,0,0
1383853,2,1,2,6,-4,4,0,0
1383853,4,1,4,12,-8,8,0,0
1383853,5,1,5,11,-6,6,0,0
1384775,1,1,0,0,0,0,0,0
1384775,2,1,5,4,1,0,1,0
1390913,1,1,4,4,0,0,0,0
1390913,2,1,0,0,0,0,0,0
1392411,2,1,14,11,3,0,3,2
1392411,3,1,19,10,9,0,9,8
1392915,3,1,2,4,-2,2,0,0
1392915,4,1,6,4,2,0,2,2
1393607,1,1,8,4,4,0,4,0
1393607,2,1,10,9,1,0,1,1
1393814,1,1,12,8,4,0,4,4
1393814,2,1,2,2,0,0,0,0
1395854,1,1,3,3,0,0,0,0
1395854,2,1,5,5,0,0,0,0
1396611,2,1,4,6,-2,3,1,1
1396611,4,1,7,2,5,1,6,1
1396945,1,1,14,2,12,0,12,8
1396945,2,1,2,2,0,0,0,0
1397218,2,1,0,0,0,0,0,0
1397218,3,1,2,3,-1,2,1,1
1399011,1,1,3,3,0,0,0,0
1399011,2,1,5,5,0,0,0,0
1399693,1,1,3,8,-5,5,0,0
1399703,1,1,3,5,-2,2,0,0
1399703,2,1,4,4,0,0,0,0
1399703,3,1,7,6,1,0,1,1
1400451,1,1,5,7,-2,2,0,0
1400664,1,1,4,4,0,0,0,0
1400664,2,1,6,5,1,0,1,1
1400727,1,1,6,6,0,0,0,0
1401062,1,1,4,6,-2,2,0,0
1401062,2,1,7,6,1,0,1,0
1401065,1,1,3,4,-1,1,0,0
1401065,2,1,2,2,0,0,0,0
1401091,1,1,13,9,4,0,4,1
1401091,2,1,8,5,3,0,3,3
1401091,3,1,38,7,31,0,31,11
1401091,4,1,8,5,3,0,3,0
1401220,1,1,5,4,1,2,3,3
1401220,2,1,8,7,1,0,1,1
1401414,1,1,9,8,1,2,3,3
1401414,2,1,6,5,1,0,1,1
1401502,1,1,0,0,0,0,0,0
1401502,2,1,6,6,0,0,0,0
1401507,1,1,14,9,5,0,5,4
1401507,2,1,3,3,0,0,0,0
1401761,1,1,6,1,5,0,5,3
1401984,1,1,8,3,5,0,5,3
1402016,1,1,4,4,0,0,0,0
1402016,2,1,4,4,0,0,0,0
1402216,1,1,0,0,0,0,0,0
1402216,2,1,1,2,-1,1,0,0
1402216,3,1,0,0,0,0,0,0
1402216,4,1,4,3,1,0,1,1
1402219,1,1,7,3,4,0,4,4
1402219,2,1,4,8,-4,4,0,0
1402225,1,1,3,3,0,0,0,0
1402225,2,1,2,2,0,0,0,0
1402560,1,1,8,4,4,0,4,4
1402560,2,1,12,7,5,0,5,4
1402560,3,1,5,10,-5,5,0,0
1402864,1,1,11,3,8,0,8,7
1403033,1,1,0,0,0,0,0,0
1403542,1,1,11,8,3,2,5,5
1403542,2,1,3,4,-1,1,0,0
1403542,3,1,5,4,1,0,1,1
1403711,1,1,10,2,8,0,8,8
1403711,2,1,8,3,5,0,5,3
1404062,1,1,1,4,-3,3,0,0
1404062,2,1,2,2,0,0,0,0
1404071,1,1,6,5,1,0,1,1
1404071,2,1,13,14,-1,1,0,0
1404254,1,1,8,7,1,0,1,0
1404277,1,1,2,2,0,0,0,0
1404556,1,1,6,5,1,0,1,0
1404809,1,1,5,6,-1,1,0,0
1404809,2,1,1,3,-2,2,0,0
1405461,1,1,8,6,2,0,2,2
1405469,1,1,14,4,10,0,10,2
1405469,2,1,6,4,2,0,2,0
1405500,1,1,3,2,1,0,1,1
1405500,2,1,2,2,0,0,0,0
1405500,3,1,0,0,0,0,0,0
1405758,1,1,4,4,0,0,0,0
1405758,2,1,2,4,-2,2,0,0
1406374,1,1,5,4,1,0,1,1
1406526,1,1,0,0,0,0,0,0
1406695,1,1,5,4,1,0,1,1
1406695,2,1,4,2,2,0,2,2
1407506,1,1,12,4,8,0,8,8
1407506,2,1,6,2,4,0,4,4
1407624,1,1,14,7,7,0,7,7
1407624,2,1,2,13,-11,11,0,0
1407783,1,1,10,9,1,4,5,4
1407783,2,1,9,9,0,1,1,1
1408058,1,1,5,5,0,0,0,0
1408500,1,1,11,7,4,0,4,4
1408666,1,1,7,6,1,0,1,0
1408666,2,1,7,6,1,0,1,0
1409214,1,1,4,4,0,0,0,0
1409214,2,1,11,7,4,0,4,2
1409347,1,1,6,2,4,0,4,4
1409347,2,1,7,13,-6,8,2,2
1409690,1,1,2,2,0,0,0,0
1409690,2,1,2,2,0,0,0,0
1409775,1,1,7,6,1,3,4,3
1409775,2,1,15,14,1,0,1,1
1409775,3,1,3,4,-1,1,0,0
1410233,1,1,0,0,0,0,0,0
1410233,2,1,2,2,0,0,0,0
1410286,1,1,7,7,0,0,0,0
1410286,2,1,8,5,3,0,3,3
1410336,1,1,11,10,1,0,1,1
1410336,2,1,6,6,0,0,0,0
1411200,1,1,3,4,-1,1,0,0
1411200,2,1,3,2,1,0,1,1
1411499,1,1,14,13,1,1,2,2
1412114,1,1,2,2,0,0,0,0
1412114,2,1,6,5,1,0,1,1
1412205,1,1,4,4,0,0,0,0
1412411,1,1,8,9,-1,1,0,0
1412411,2,1,4,10,-6,6,0,0
1412411,4,1,0,0,0,0,0,0
1413043,1,1,9,6,3,0,3,3
1413091,1,1,0,0,0,0,0,0
1414126,1,1,3,3,0,1,1,1
1414264,2,1,2,2,0,0,0,0
1414264,3,1,5,9,-4,5,1,1
1414675,1,1,10,8,2,0,2,2
1414675,2,1,4,4,0,0,0,0
1415236,1,1,6,6,0,0,0,0
1415236,2,1,11,10,1,0,1,1
1415700,1,1,6,6,0,0,0,0
1415988,1,1,8,6,2,0,2,2
1415988,2,1,10,10,0,3,3,1
1416023,1,1,4,4,0,0,0,0
1416023,2,1,10,5,5,0,5,5
1416253,1,1,2,2,0,0,0,0
1416253,2,1,2,2,0,0,0,0
1416483,1,1,16,14,2,0,2,1
1416878,1,1,8,8,0,0,0,0
1416878,2,1,2,3,-1,1,0,0
1416933,1,1,17,12,5,0,5,4
1416933,2,1,5,4,1,0,1,0
1417459,1,1,6,8,-2,3,1,0
1417481,1,1,3,3,0,1,1,1
1417571,1,1,6,4,2,0,2,2
1417571,2,1,0,0,0,0,0,0
1417829,1,1,8,8,0,0,0,0
1417829,2,1,7,6,1,0,1,0
1417829,3,1,12,7,5,0,5,0
1417970,1,1,4,4,0,0,0,0
1417970,2,1,1,2,-1,1,0,0
1418036,1,1,7,7,0,0,0,0
1418141,1,1,4,4,0,0,0,0
1418141,2,1,3,4,-1,1,0,0
1418292,1,1,14,12,2,0,2,1
1418292,2,1,0,0,0,0,0,0
1418363,1,1,11,7,4,2,6,6
1419130,1,1,19,7,12,0,12,11
1419130,2,1,11,10,1,1,2,1
1419130,3,1,10,4,6,0,6,6
1419459,1,1,9,4,5,0,5,5
1420334,1,1,8,4,4,0,4,4
1421052,1,1,3,3,0,0,0,0
1421052,2,1,3,3,0,0,0,0
1421226,1,1,5,5,0,0,0,0
1421695,1,1,1,0,1,0,1,0
1421695,2,1,7,10,-3,6,3,2
1421695,3,1,8,4,4,2,6,0
1423009,1,1,14,14,0,0,0,0
1423009,2,1,5,5,0,0,0,0
1423284,1,1,1,0,1,0,1,0
1423284,2,1,5,5,0,0,0,0
1423347,1,1,6,5,1,3,4,4
1423347,2,1,4,2,2,0,2,2
1423388,1,1,2,2,0,0,0,0
1423388,2,1,2,2,0,0,0,0
1423388,3,1,7,2,5,0,5,2
1423641,1,1,20,5,15,0,15,0
1423641,2,1,7,7,0,0,0,0
1423642,1,1,2,6,-4,4,0,0
1424002,1,1,1,6,-5,5,0,0
1424002,2,1,2,4,-2,3,1,1
1424084,1,1,12,7,5,3,12,10
1424084,2,1,1,3,-2,2,0,0
1424097,1,1,2,2,0,0,0,0
1424097,2,1,3,6,-3,3,0,0
1424373,1,1,11,10,1,0,1,0
1424845,1,1,17,3,14,0,14,14
1424845,2,1,5,4,1,0,1,1
1424845,3,1,2,2,0,0,0,0
1424888,1,1,9,11,-2,2,0,0
1424888,2,1,12,13,-1,2,1,0
1425142,1,1,1,3,-2,2,0,0
1425142,2,1,4,3,1,1,2,2
1425459,1,1,6,4,2,0,2,1
1425459,2,1,3,2,1,0,1,1
1425459,3,1,11,5,6,0,6,2
1425734,1,1,5,6,-1,3,2,2
1425734,2,1,6,5,1,0,1,1
1426099,1,1,0,0,0,0,0,0
1426099,2,1,4,3,1,0,1,1
1426099,3,1,20,8,12,1,13,13
1426808,1,1,8,5,3,0,3,3
1426808,2,1,0,0,0,0,0,0
1426971,1,1,6,4,2,0,2,2
1427743,1,1,10,8,2,1,3,3
1428793,1,1,4,4,0,0,0,0
1428793,2,1,3,4,-1,2,1,1
1428932,3,1,18,2,16,0,16,6
1428999,1,1,0,0,0,0,0,0
1428999,2,1,1,2,-1,1,0,0
1429511,1,1,21,21,0,0,0,0
1430715,1,1,5,6,-1,3,2,0
1430720,1,1,7,3,4,0,4,3
1430720,2,1,0,0,0,0,0,0
1431481,1,1,7,5,2,0,2,2
1431481,2,1,5,8,-3,4,1,1
1431576,1,1,4,3,1,0,1,1
1431576,2,1,0,0,0,0,0,0
1431727,1,1,12,10,2,0,2,1
1431727,2,1,5,5,0,0,0,0
1432381,1,1,7,6,1,0,1,1
1432381,2,1,8,6,2,0,2,2
1432531,1,1,6,8,-2,3,1,1
1432531,2,1,4,4,0,0,0,0
1432536,1,1,0,0,0,0,0,0
1432536,2,1,6,5,1,0,1,1
1433347,1,1,12,7,5,0,5,4
1433347,2,1,5,7,-2,3,1,1
1435087,1,1,6,6,0,0,0,0
1435087,2,1,5,2,3,0,3,0
1435171,1,1,2,2,0,0,0,0
1435450,1,1,2,2,0,0,0,0
1435615,1,1,5,5,0,0,0,0
1435615,2,1,4,4,0,0,0,0
1435615,3,1,3,3,0,0,0,0
1435784,1,1,5,3,2,1,3,3
1435784,2,1,8,5,3,3,6,6
1436534,1,1,9,10,-1,1,0,0
1436629,1,1,6,6,0,0,0,0
1437046,1,1,7,6,1,0,1,0
1437046,2,1,5,6,-1,1,0,0
1437129,1,1,4,6,-2,2,0,0
1437129,2,1,9,8,1,0,1,1
1437129,3,1,5,4,1,0,1,1
1437476,1,1,4,4,0,0,0,0
1437593,1,1,8,10,-2,2,0,0
1437782,1,1,1,0,1,0,1,0
1437782,2,1,16,8,8,0,8,5
1438010,1,1,0,0,0,0,0,0
1438674,1,1,7,7,0,0,0,0
1438674,2,1,6,6,0,0,0,0
1438713,1,1,5,4,1,0,1,0
1438713,2,1,3,3,0,1,1,0
1439359,1,1,0,0,0,0,0,0
1439600,1,1,8,2,6,0,6,5
1439600,2,1,75,0,75,0,75,0
1440062,1,1,16,15,1,2,3,2
1440062,2,1,13,8,5,1,6,6
1440125,1,1,10,10,0,0,0,0
1440125,2,1,1,4,-3,3,0,0
1440125,3,1,5,4,1,0,1,1
1440133,1,1,3,3,0,0,0,0
1440204,1,1,3,2,1,0,1,1
1440204,2,1,4,2,2,0,2,2
1440787,1,1,0,0,0,0,0,0
1440787,2,1,0,0,0,0,0,0
1441301,1,1,4,4,0,0,0,0
1441301,2,1,3,4,-1,1,0,0
1441369,1,1,4,5,-1,1,0,0
1441497,1,1,1,5,-4,4,0,0
1442328,1,1,0,0,0,0,0,0
1442328,2,1,10,8,2,0,2,2
1442550,1,1,11,10,1,0,1,1
1442550,2,1,0,0,0,0,0,0
1442580,1,1,6,6,0,0,0,0
1442580,2,1,5,5,0,0,0,0
1443035,1,1,2,2,0,0,0,0
1443181,1,1,4,3,1,0,1,1
1443181,3,1,8,6,2,0,2,2
1443466,1,1,13,14,-1,2,1,1
1443466,2,1,5,7,-2,3,1,0
1444009,1,1,2,11,-9,10,1,1
1444737,1,1,5,5,0,0,0,0
1444737,2,1,9,4,5,0,5,5
1445016,1,1,6,4,2,1,3,3
1445016,2,1,2,1,1,0,1,0
1445369,1,1,9,9,0,1,1,1
1445369,2,1,5,5,0,1,1,1
1446111,1,1,10,10,0,2,2,2
1446567,1,1,1,4,-3,3,0,0
1446567,2,1,11,6,5,0,5,5
1447133,1,1,4,4,0,0,0,0
1447133,2,1,2,2,0,0,0,0
1447679,2,1,6,6,0,0,0,0
1448287,1,1,7,6,1,0,1,1
1448333,1,1,5,5,0,0,0,0
1448333,2,1,12,7,5,1,6,5
1449872,1,1,8,5,3,0,3,0
1449872,2,1,2,2,0,0,0,0
1451605,1,1,4,4,0,0,0,0
1452337,1,1,30,9,21,0,21,8
1452337,2,1,9,6,3,0,3,3
1452469,1,1,8,9,-1,2,1,1
1452469,2,1,3,3,0,0,0,0
1452518,1,1,4,2,2,0,2,2
1452518,2,1,4,3,1,0,1,1
1452535,1,1,6,5,1,0,1,1
1452535,2,1,3,2,1,0,1,1
1452586,1,1,6,8,-2,3,1,1
1452586,2,1,11,14,-3,3,0,0
1452613,1,1,7,6,1,0,1,0
1452620,1,1,6,4,2,0,2,2
1452620,2,1,1,1,0,0,0,0
1452668,1,1,11,11,0,5,5,4
1452668,2,1,3,6,-3,4,1,1
1452668,3,1,5,4,1,0,1,1
1452803,1,1,0,0,0,0,0,0
1452803,2,1,7,6,1,0,1,1
1452915,1,1,8,8,0,0,0,0
1452915,2,1,16,6,10,1,11,3
1452982,1,1,6,6,0,0,0,0
1452982,2,1,11,6,5,0,5,0
1453465,1,1,5,6,-1,2,1,1
1453480,3,1,3,5,-2,2,0,0
1453480,4,1,5,5,0,0,0,0
1453614,1,1,3,6,-3,4,1,0
1453614,2,1,2,4,-2,2,0,0
1453833,1,1,13,11,2,0,2,2
1453833,2,1,13,11,2,1,3,3
1453864,1,1,5,5,0,0,0,0
1454172,1,1,6,6,0,0,0,0
1454172,2,1,8,6,2,0,2,1
1454549,1,1,8,8,0,0,0,0
1454549,2,1,10,7,3,0,3,3
1454564,1,1,2,2,0,0,0,0
1455851,1,1,4,2,2,0,2,1
1455851,2,1,4,2,2,0,2,2
1455927,1,1,4,6,-2,2,0,0
1456024,1,1,9,9,0,0,0,0
1456024,2,1,0,0,0,0,0,0
1456036,1,1,7,2,5,0,5,2
1456036,2,1,4,2,2,0,2,0
1456161,1,1,9,9,0,0,0,0
1456161,2,1,0,0,0,0,0,0
1456671,2,1,7,8,-1,1,0,0
1456671,3,1,4,4,0,0,0,0
1456838,1,1,4,3,1,0,1,0
1456838,2,1,5,5,0,0,0,0
1457273,1,1,3,2,1,0,1,1
1457273,2,1,2,2,0,0,0,0
1457273,3,1,18,9,9,0,9,8
1457286,1,1,7,6,1,0,1,1
1457286,2,1,3,3,0,0,0,0
1457286,3,1,4,6,-2,4,2,2
1457286,4,1,3,3,0,0,0,0
1458245,1,1,6,6,0,0,0,0
1458245,2,1,11,10,1,0,1,0
1458355,1,1,6,6,0,0,0,0
1458355,2,1,2,2,0,0,0,0
1458388,1,1,20,18,2,0,2,2
1458388,2,1,1,11,-10,10,0,0
1458613,2,1,0,0,0,0,0,0
1458613,3,1,0,0,0,0,0,0
1459041,1,1,7,7,0,0,0,0
1459041,2,1,4,7,-3,3,0,0
1459402,1,1,0,0,0,0,0,0
1459509,1,1,4,4,0,0,0,0
1459509,2,1,0,0,0,0,0,0
1459723,1,1,0,0,0,0,0,0
1459809,1,1,3,2,1,0,1,1
1460101,1,1,4,5,-1,1,0,0
1460101,2,1,12,17,-5,6,1,1
1460285,1,1,4,6,-2,3,1,1
1460384,1,1,9,9,0,0,0,0
1460384,2,1,2,5,-3,3,0,0
1460679,1,1,3,2,1,0,1,1
1460679,3,1,3,2,1,1,2,2
1461247,1,1,3,3,0,0,0,0
1461303,3,1,16,10,6,1,7,7
1461383,2,1,14,6,8,0,8,0
1461383,3,1,8,6,2,3,5,0
1462259,1,1,8,5,3,0,3,0
1462600,1,1,13,11,2,0,2,1
1462600,2,1,8,7,1,0,1,1
1462881,1,1,6,5,1,0,1,1
1463095,1,1,2,2,0,0,0,0
1463144,1,1,3,3,0,0,0,0
1463144,2,1,2,2,0,0,0,0
1463288,1,1,4,2,2,0,2,2
1463288,2,1,3,2,1,0,1,1
1463370,1,1,4,4,0,0,0,0
1463370,2,1,7,5,2,0,2,2
1463421,1,1,5,5,0,0,0,0
1463421,2,1,3,7,-4,4,0,0
1463628,1,1,1,5,-4,4,0,0
1463831,1,1,4,4,0,0,0,0
1463831,2,1,7,7,0,0,0,0
1463905,1,1,2,2,0,0,0,0
1463905,2,1,3,3,0,0,0,0
1464567,1,1,0,0,0,0,0,0
1464567,2,1,0,0,0,0,0,0
1464567,3,1,0,0,0,0,0,0
1464676,1,1,10,7,3,0,3,1
1464676,2,1,13,8,5,0,5,3
1465095,1,1,2,2,0,0,0,0
1465095,2,1,6,4,2,1,3,3
1465164,1,1,6,6,0,0,0,0
1465250,1,1,5,6,-1,1,0,0
1465359,1,1,15,15,0,0,0,0
1466079,1,1,5,3,2,0,2,2
1466079,2,1,0,0,0,0,0,0
1466137,1,1,11,10,1,0,1,0
1466137,2,1,3,3,0,0,0,0
1466137,3,1,2,3,-1,1,0,0
1466404,1,1,9,7,2,0,2,0
1466404,2,1,3,3,0,0,0,0
1466613,1,1,2,2,0,0,0,0
1466613,2,1,0,0,0,0,0,0
1466613,3,1,4,2,2,0,2,2
1466793,1,1,10,9,1,0,1,0
1466793,2,1,5,5,0,2,2,2
1466793,3,1,4,4,0,0,0,0
1466793,4,1,5,3,2,0,2,2
1466793,5,1,5,4,1,0,1,1
1466877,1,1,8,6,2,0,2,1
1467073,1,1,11,9,2,0,2,2
1467073,2,1,11,9,2,0,2,2
1467253,1,1,10,8,2,0,2,0
1467488,1,1,11,9,2,0,2,2
1467488,2,1,6,5,1,0,1,1
1468356,1,1,4,4,0,0,0,0
1468356,2,1,4,4,0,0,0,0
1468748,1,1,7,5,2,0,2,2
1468748,2,1,3,3,0,0,0,0
1470082,1,1,4,7,-3,3,0,0
1470325,1,1,3,3,0,0,0,0
1470325,2,1,6,6,0,0,0,0
1470335,1,1,6,5,1,0,1,0
1470335,2,1,0,0,0,0,0,0
1470792,1,1,0,0,0,0,0,0
1471197,1,1,3,3,0,0,0,0
1471197,2,1,0,0,0,0,0,0
1471197,3,1,12,6,6,0,6,0
1471289,1,1,7,3,4,0,4,4
1471289,2,1,8,5,3,0,3,3
1471415,1,1,6,5,1,0,1,0
1471415,2,1,3,2,1,0,1,0
1471549,1,1,6,6,0,0,0,0
1471549,2,1,4,5,-1,2,1,1
1471549,3,1,18,16,2,1,3,1
1471549,4,1,9,6,3,0,3,3
1471768,1,1,4,4,0,0,0,0
1471768,2,1,3,3,0,0,0,0
1471960,1,1,8,4,4,0,4,3
1471960,2,1,0,0,0,0,0,0
1472664,1,1,4,4,0,0,0,0
1472664,2,1,2,3,-1,1,0,0
1472827,1,1,3,7,-4,4,0,0
1472827,2,1,2,2,0,0,0,0
1473154,1,1,7,5,2,0,2,1
1473154,2,1,0,0,0,0,0,0
1473154,3,1,6,6,0,2,2,2
1473715,1,1,4,6,-2,2,0,0
1473715,2,1,9,9,0,1,1,1
1473894,1,1,9,9,0,0,0,0
1473894,2,1,4,4,0,0,0,0
1474620,1,1,4,5,-1,1,0,0
1474620,2,1,1,6,-5,5,0,0
1474991,1,1,5,4,1,0,1,0
1474991,2,1,5,11,-6,6,0,0
1475220,1,1,0,0,0,0,0,0
1475800,1,1,2,6,-4,4,0,0
1475800,2,1,4,2,2,0,2,2
1476119,1,1,2,2,0,0,0,0
1476119,2,1,4,3,1,0,1,1
1476661,1,1,0,0,0,0,0,0
1476771,1,1,7,10,-3,3,0,0
1476771,2,1,0,0,0,0,0,0
1477286,1,1,12,12,0,0,0,0
1477286,2,1,13,11,2,0,2,2
1477893,1,1,4,4,0,0,0,0
1477893,2,1,2,4,-2,2,0,0
1478280,1,1,20,13,7,2,9,1
1478419,1,1,12,6,6,0,6,0
1478684,1,1,6,3,3,0,3,3
1479026,1,1,3,3,0,0,0,0
1479109,1,1,5,8,-3,3,0,0
1479109,2,1,1,6,-5,5,0,0
1479109,3,1,4,2,2,0,2,2
1479190,1,1,7,8,-1,1,0,0
1479190,2,1,0,0,0,0,0,0
1479233,1,1,9,5,4,0,4,4
1479233,2,1,3,2,1,0,1,1
1479351,1,1,6,6,0,0,0,0
1479351,2,1,13,11,2,0,2,0
1479351,3,1,2,2,0,0,0,0
1479757,1,1,8,2,6,1,7,1
1479757,2,1,6,6,0,0,0,0
1479757,3,1,0,0,0,0,0,0
1480008,1,1,7,5,2,0,2,2
1480243,1,1,3,4,-1,1,0,0
1480243,2,1,8,2,6,0,6,6
1480512,1,1,2,2,0,0,0,0
1480613,1,1,9,6,3,0,3,3
1480613,2,1,0,0,0,0,0,0
1480857,1,1,9,5,4,0,4,3
1480857,2,1,1,2,-1,1,0,0
1481136,1,1,35,6,29,0,29,15
1481136,2,1,0,0,0,0,0,0
1481289,1,1,4,2,2,0,2,2
1481289,2,1,4,2,2,0,2,2
1482254,2,1,6,6,0,1,1,1
1483152,1,1,8,8,0,0,0,0
1483152,2,1,14,11,3,0,3,2
1483750,1,1,0,0,0,0,0,0
1483750,2,1,1,2,-1,1,0,0
1484218,1,1,2,2,0,0,0,0
1484218,2,1,3,2,1,0,1,1
1484309,1,1,8,8,0,0,0,0
1484385,1,1,6,6,0,0,0,0
1484385,2,1,2,5,-3,3,0,0
1485088,1,1,7,6,1,0,1,1
1485307,1,1,5,5,0,0,0,0
1485307,2,1,4,3,1,0,1,1
1485392,1,1,9,7,2,0,2,2
1485392,2,1,0,0,0,0,0,0
1485522,1,1,7,7,0,0,0,0
1485522,2,1,3,2,1,0,1,0
1485619,1,1,2,2,0,0,0,0
1485827,1,1,4,4,0,0,0,0
1486219,2,1,6,4,2,0,2,1
1487654,2,1,2,2,0,0,0,0
1488049,1,1,8,7,1,1,2,2
1488049,2,1,12,10,2,0,2,0
1488097,1,1,4,3,1,0,1,1
1488097,2,1,8,4,4,0,4,4
1488156,1,1,6,6,0,0,0,0
1488156,2,1,14,8,6,0,6,1
1488313,1,1,7,6,1,0,1,1
1488313,2,1,6,4,2,0,2,1
1489029,1,1,13,12,1,6,7,1
1489029,2,1,6,5,1,2,3,2
1489029,3,1,1,3,-2,2,0,0
1489279,1,1,0,0,0,0,0,0
1489279,2,1,0,0,0,0,0,0
1489338,1,1,0,0,0,0,0,0
1489338,2,1,0,0,0,0,0,0
1489454,1,1,4,5,-1,2,1,1
1489454,2,1,5,5,0,0,0,0
1489528,1,1,6,6,0,0,0,0
1489528,2,1,3,3,0,0,0,0
1489758,1,1,10,5,5,0,5,5
1489864,1,1,4,3,1,0,1,1
1489864,2,1,4,6,-2,2,0,0
1490254,1,1,8,5,3,0,3,3
1490467,1,1,0,0,0,0,0,0
1490467,2,1,0,0,0,0,0,0
1490741,1,1,3,11,-8,8,0,0
1490741,2,1,4,9,-5,5,0,0
1490945,1,1,10,3,7,0,7,7
1490945,2,1,0,0,0,0,0,0
1491180,1,1,0,0,0,0,0,0
1491726,1,1,6,8,-2,3,1,1
1491726,2,1,9,7,2,0,2,2
1492549,1,1,5,5,0,0,0,0
1492549,2,1,5,5,0,0,0,0
1492997,1,1,6,4,2,2,4,4
1493200,1,1,0,0,0,0,0,0
1493383,1,1,4,2,2,0,2,2
1493400,2,1,4,4,0,0,0,0
1493487,1,1,12,12,0,3,3,3
1493487,2,1,8,3,5,0,5,5
1493487,3,1,3,2,1,0,1,1
1493604,1,1,7,8,-1,2,1,0
1493649,1,1,7,3,4,0,4,4
1493649,2,1,6,7,-1,3,2,2
1493678,1,1,2,4,-2,2,0,0
1493851,1,1,6,6,0,0,0,0
1493851,2,1,13,13,0,1,1,1
1494055,1,1,7,6,1,0,1,1
1494244,1,1,4,8,-4,4,0,0
1494244,2,1,0,0,0,0,0,0
1494422,1,1,8,4,4,0,4,4
1494422,2,1,3,4,-1,1,0,0
1495334,1,1,6,6,0,0,0,0
1495334,2,1,6,6,0,0,0,0
1495515,1,1,0,0,0,0,0,0
1495623,1,1,0,0,0,0,0,0
1495689,1,1,5,8,-3,3,0,0
1495689,2,1,3,13,-10,10,0,0
1496092,1,1,11,9,2,0,2,2
1496092,2,1,5,3,2,0,2,2
1497082,1,1,8,5,3,2,5,4
1497082,2,1,4,4,0,0,0,0
1497287,1,1,6,6,0,0,0,0
1497287,2,1,3,4,-1,1,0,0
1497337,1,1,2,2,0,0,0,0
1497337,2,1,6,6,0,0,0,0
1497608,1,1,3,2,1,0,1,1
1497608,2,1,5,4,1,0,1,1
1497788,1,1,15,14,1,1,2,2
1497788,2,1,5,6,-1,1,0,0
1498504,1,1,1,4,-3,3,0,0
1498587,2,1,6,6,0,0,0,0
1498756,1,1,4,4,0,0,0,0
1498815,1,1,4,8,-4,5,1,1
1498936,1,1,2,2,0,0,0,0
1498936,2,1,5,3,2,0,2,2
1498957,1,1,15,15,0,0,0,0
1499177,1,1,0,0,0,0,0,0
1499177,2,1,2,2,0,0,0,0
1500935,1,1,9,10,-1,1,0,0
1500935,2,1,10,15,-5,5,0,0
1501118,1,1,15,12,3,0,3,2
1501118,2,1,7,7,0,0,0,0
1502500,1,1,11,5,6,2,8,8
1502500,2,1,13,8,5,0,5,5
1502650,1,1,8,8,0,0,0,0
1502650,2,1,13,10,3,0,3,2
1502871,1,1,0,0,0,0,0,0
1502871,2,1,3,3,0,0,0,0
1503228,1,1,1,2,-1,1,0,0
1503228,2,1,4,2,2,0,2,2
1504148,1,1,4,4,0,0,0,0
1504148,2,1,5,2,3,0,3,3
1504746,1,1,7,7,0,0,0,0
1504746,2,1,9,8,1,1,2,2
1504746,3,1,20,11,9,1,10,9
1504768,1,1,8,6,2,3,5,5
1504922,3,1,5,2,3,0,3,2
1504922,4,1,2,2,0,0,0,0
1504935,1,1,6,6,0,0,0,0
1505412,1,1,2,5,-3,3,0,0
1505708,1,1,3,2,1,0,1,1
1505708,2,1,5,5,0,0,0,0
1506707,1,1,5,5,0,1,1,1
1506939,1,1,14,11,3,0,3,0
1506939,2,1,4,5,-1,1,0,0
1507195,1,1,14,2,12,0,12,11
1507560,1,1,11,6,5,0,5,2
1507560,2,1,1,5,-4,4,0,0
1508142,1,1,14,3,11,0,11,1
1508142,2,1,4,3,1,0,1,1
1508412,1,1,5,4,1,0,1,0
1508412,2,1,0,0,0,0,0,0
1509183,1,1,22,18,4,1,5,2
1509183,2,1,8,2,6,0,6,6
1509209,1,1,4,10,-6,6,0,0
1509209,2,1,3,10,-7,9,2,0
1509209,3,1,15,6,9,2,11,0
1509422,1,1,5,5,0,0,0,0
1509422,2,1,6,5,1,0,1,1
1509619,1,1,11,5,6,0,6,4
1509619,2,1,0,0,0,0,0,0
1510060,1,1,5,7,-2,2,0,0
1510860,1,1,3,3,0,0,0,0
1511662,1,1,18,13,5,0,5,4
1511662,2,1,7,2,5,0,5,1
1511662,3,1,4,2,2,0,2,2
1511764,1,1,6,6,0,0,0,0
1511764,2,1,6,7,-1,1,0,0
1511996,1,1,6,6,0,0,0,0
1511996,2,1,12,6,6,2,8,3
1512746,1,1,4,4,0,0,0,0
1512746,2,1,13,7,6,0,6,6
1512746,3,1,11,10,1,0,1,1
1512746,4,1,0,0,0,0,0,0
1513075,1,1,6,13,-7,8,1,1
1513075,2,1,8,6,2,0,2,1
1513345,2,1,2,2,0,0,0,0
1513384,1,1,3,3,0,1,1,1
1513384,2,1,2,2,0,0,0,0
1513384,3,1,9,4,5,0,5,0
1513522,1,1,6,5,1,0,1,1
1513559,1,1,6,7,-1,1,0,0
1513559,2,1,4,5,-1,1,0,0
1513559,4,1,5,4,1,0,1,1
1513686,1,1,25,16,9,3,12,12
1513686,2,1,1,5,-4,4,0,0
1513686,3,1,3,6,-3,4,1,1
1514353,1,1,2,2,0,0,0,0
1514353,2,1,6,4,2,0,2,2
1514353,4,1,13,4,9,0,9,9
1514387,1,1,2,2,0,0,0,0
1514387,3,1,4,4,0,0,0,0
1514671,1,1,10,8,2,1,3,3
1514816,1,1,1,4,-3,3,0,0
1515640,1,1,2,2,0,0,0,0
1515640,2,1,5,4,1,1,2,2
1517055,1,1,10,9,1,0,1,1
1517055,2,1,1,6,-5,5,0,0
1517305,1,1,7,6,1,0,1,1
1517305,2,1,2,3,-1,1,0,0
1518236,1,1,12,8,4,0,4,0
1518236,2,1,9,8,1,0,1,0
1518644,1,1,2,4,-2,2,0,0
1518677,1,1,4,4,0,0,0,0
1518677,2,1,0,0,0,0,0,0
1519302,1,1,9,6,3,0,3,3
1519405,1,1,12,18,-6,8,2,2
1519405,2,1,3,2,1,0,1,1
1519528,1,1,4,4,0,0,0,0
1519528,2,1,12,2,10,0,10,2
1519634,1,1,2,2,0,0,0,0
1519839,1,1,3,1,2,0,2,2
1519923,1,1,12,15,-3,4,1,1
1519923,2,1,4,5,-1,2,1,1
1519923,3,1,4,6,-2,3,1,1
1519923,4,1,6,5,1,1,2,2
1520106,1,1,3,4,-1,1,0,0
1520581,1,1,1,2,-1,1,0,0
1520581,2,1,2,2,0,0,0,0
1520682,1,1,8,9,-1,1,0,0
1520801,1,1,9,8,1,0,1,1
1520801,2,1,7,7,0,0,0,0
1520801,3,1,5,7,-2,2,0,0
1521032,1,1,7,9,-2,3,1,1
1521032,2,1,3,3,0,0,0,0
1521110,1,1,10,13,-3,6,3,3
1521128,1,1,9,3,6,0,6,6
1521128,2,1,2,2,0,0,0,0
1521281,1,1,4,4,0,0,0,0
1521954,1,1,10,7,3,0,3,3
1522391,1,1,4,4,0,0,0,0
1522391,2,1,0,0,0,0,0,0
1523030,1,1,4,4,0,0,0,0
1523030,2,1,6,8,-2,2,0,0
1523397,1,1,4,4,0,0,0,0
1523397,2,1,7,6,1,0,1,1
1524172,1,1,3,3,0,0,0,0
1525172,1,1,7,4,3,0,3,0
1525645,1,1,9,7,2,0,2,0
1525645,2,1,11,11,0,0,0,0
1525645,3,1,2,2,0,0,0,0
1526058,1,1,6,6,0,0,0,0
1526367,1,1,8,8,0,0,0,0
1526367,2,1,8,6,2,0,2,1
1527001,1,1,0,0,0,0,0,0
1527001,2,1,2,4,-2,2,0,0
1527259,1,1,11,6,5,0,5,2
1527282,1,1,5,5,0,2,2,2
1527282,2,1,6,6,0,0,0,0
1527456,1,1,1,1,0,0,0,0
1527456,2,1,1,2,-1,1,0,0
1527855,1,1,5,7,-2,3,1,1
1527855,2,1,10,9,1,1,2,2
1527855,3,1,10,3,7,0,7,0
1527884,1,1,15,13,2,0,2,2
1527884,2,1,7,6,1,0,1,1
1528566,1,1,7,5,2,0,2,2
1528566,2,1,6,5,1,0,1,1
1528566,3,1,4,2,2,0,2,2
1529010,2,1,0,0,0,0,0,0
1529010,3,1,0,0,0,0,0,0
1529010,5,1,0,0,0,0,0,0
1529066,1,1,5,3,2,0,2,2
1529066,2,1,3,3,0,0,0,0
1529149,1,1,11,9,2,0,2,2
1529149,2,1,6,2,4,0,4,0
1529263,1,1,12,9,3,1,4,2
1529263,2,1,3,2,1,1,2,0
1529383,1,1,4,2,2,0,2,2
1529807,1,1,6,3,3,0,3,2
1529807,2,1,7,7,0,1,1,1
1531455,1,1,9,6,3,1,4,0
1531455,2,1,3,3,0,0,0,0
1531455,3,1,2,2,0,0,0,0
1531620,1,1,15,10,5,0,5,5
1531759,1,1,6,6,0,0,0,0
1531759,3,1,2,1,1,0,1,0
1531759,4,1,11,10,1,2,3,2
1532555,1,1,4,4,0,0,0,0
1532555,2,1,0,0,0,0,0,0
1533517,1,1,4,2,2,0,2,2
1533517,2,1,5,6,-1,1,0,0
1535155,1,1,11,9,2,0,2,1
1535360,1,1,2,7,-5,5,0,0
1535360,2,1,2,2,0,0,0,0
1535360,3,1,9,8,1,2,3,0
1536335,1,1,10,10,0,2,2,2
1536972,1,1,3,3,0,0,0,0
1537237,1,1,10,13,-3,3,0,0
1537445,1,1,11,10,1,0,1,1
1537445,2,1,0,0,0,0,0,0
1537664,1,1,6,6,0,0,0,0
1537690,1,1,0,0,0,0,0,0
1537690,2,1,3,3,0,0,0,0
1537761,1,1,8,5,3,0,3,2
1537808,1,1,0,0,0,0,0,0
1537808,2,1,0,0,0,0,0,0
1538437,1,1,9,8,1,0,1,1
1538437,2,1,7,8,-1,1,0,0
1538822,1,1,12,12,0,0,0,0
1538822,2,1,7,6,1,0,1,1
1543946,1,1,15,18,-3,3,0,0
1544286,1,1,11,9,2,0,2,1
1544286,2,1,8,9,-1,1,0,0
1544286,3,1,8,7,1,0,1,0
1544286,4,1,8,6,2,0,2,0
1545052,1,1,11,11,0,2,2,2
1545052,2,1,6,8,-2,3,1,1
1545052,3,1,5,5,0,0,0,0
1546411,1,1,2,2,0,0,0,0
1546411,2,1,2,2,0,0,0,0
1548042,1,1,12,8,4,0,4,2
1548042,2,1,4,3,1,0,1,1
1600763,1,1,3,2,1,0,1,1
1601161,1,1,4,3,1,0,1,1
1605527,1,1,8,6,2,1,3,0
1605599,1,1,12,9,3,0,3,2
1605599,2,1,3,2,1,0,1,1
1634500,1,1,8,8,0,0,0,0
1634651,1,1,12,12,0,0,0,0
1634651,2,1,10,10,0,0,0,0
1634937,1,1,0,0,0,0,0,0
1635428,1,1,5,8,-3,4,1,1
1635428,2,1,14,14,0,0,0,0
1635458,1,1,5,4,1,0,1,1
1635486,1,1,8,8,0,2,2,2
1635486,2,1,4,6,-2,2,0,0
1635851,1,1,2,6,-4,4,0,0
1636178,1,1,6,8,-2,2,0,0
1636178,2,1,12,12,0,0,1,1
1636735,1,1,2,12,-10,10,0,0
1636883,1,1,4,10,-6,6,0,0
1641419,1,1,3,3,0,0,0,0
1642037,1,1,20,14,6,0,6,6
1642168,1,1,15,17,-2,2,0,0
1642168,2,1,4,4,0,0,0,0
1643997,1,1,8,7,1,0,1,0
1644379,1,1,9,8,1,0,1,1
1644379,2,1,6,6,0,0,0,0
1646072,1,1,10,6,4,0,4,4
1646072,2,1,7,7,0,2,2,2
1646187,1,1,6,6,0,0,0,0
1646324,1,1,6,6,0,0,0,0
1646324,2,1,3,2,1,0,1,0
1646393,1,1,5,4,1,0,1,1
1646393,2,1,3,2,1,0,1,1
1646661,1,1,5,6,-1,1,0,0
1646661,2,1,4,4,0,1,1,1
1647261,1,1,3,6,-3,3,0,0
1648486,1,1,1,2,-1,1,0,0
1648486,2,1,7,5,2,0,2,1
1648715,1,1,3,3,0,0,0,0
1648715,2,1,3,3,0,0,0,0
1649183,1,1,15,10,5,0,5,5
1652411,1,1,8,7,1,0,1,0
1652411,2,1,5,4,1,0,1,0
1654187,1,1,7,9,-2,2,0,0
1654187,2,1,5,4,1,0,1,1
1654636,1,1,4,7,-3,3,0,0
1654978,1,1,11,8,3,0,3,3
1675112,1,1,4,3,1,0,1,1
1675112,2,1,10,3,7,1,8,7
1675112,3,1,2,2,0,0,0,0
1675112,4,1,5,2,3,0,3,3
1675337,1,1,2,2,0,0,0,0
1675405,1,1,10,10,0,0,0,0
1675642,1,1,9,5,4,0,4,2
1675642,2,1,7,7,0,0,0,0
1675642,3,1,6,6,0,0,0,0
1675642,4,1,2,2,0,0,0,0
1675702,1,1,14,11,3,0,3,1
1675810,1,1,3,8,-5,5,0,0
1675810,2,1,10,8,2,0,2,2
1675891,1,1,2,2,0,0,0,0
1675891,2,1,4,6,-2,2,0,0
1676022,1,1,0,0,0,0,0,0
1676022,2,1,3,3,0,0,0,0
1676299,1,1,6,3,3,0,3,3
1676299,2,1,6,2,4,0,4,3
1676299,3,1,0,0,0,0,0,0
1676609,1,1,8,8,0,0,0,0
1676609,2,1,11,7,4,0,4,0
1676640,1,1,3,3,0,0,0,0
1676760,1,1,12,4,8,0,8,8
1677209,2,1,8,7,1,0,1,0
1677209,3,1,0,0,0,0,0,0
1677209,4,1,7,4,3,0,3,3
1677373,1,1,22,14,8,0,8,8
1677373,2,1,6,4,2,0,2,2
1677381,1,1,3,2,1,0,1,1
1677381,2,1,4,4,0,0,0,0
1677424,1,1,10,4,6,0,6,2
1677424,2,1,3,9,-6,6,0,0
1677424,3,1,13,12,1,1,2,1
1677467,1,1,2,2,0,0,0,0
1677469,1,1,16,12,4,1,5,3
1677469,2,1,7,10,-3,4,1,1
1677603,1,1,7,3,4,0,4,4
1677603,2,1,5,3,2,0,2,1
1677603,3,1,6,2,4,0,4,4
1678288,1,1,10,7,3,0,3,3
1678319,1,1,16,13,3,0,3,0
1678319,2,1,13,9,4,0,4,3
1678548,1,1,5,4,1,0,1,1
1678628,1,1,7,6,1,4,5,3
1678628,3,1,0,0,0,0,0,0
1678628,4,1,11,8,3,0,3,3
1679249,1,1,1,7,-6,6,0,0
1679249,3,1,6,5,1,0,1,1
1679251,1,1,11,11,0,0,0,0
1679251,2,1,12,12,0,3,3,1
1679352,1,1,2,6,-4,4,0,0
1679352,2,1,13,11,2,2,4,3
1679624,1,1,9,8,1,2,3,3
1679624,2,1,0,0,0,0,0,0
1679732,1,1,10,7,3,0,3,3
1679914,1,1,6,5,1,2,3,3
1680468,1,1,8,5,3,0,3,2
1680468,2,1,4,4,0,0,0,0
1680679,1,1,2,2,0,0,0,0
1680679,2,1,2,2,0,0,0,0
1680751,1,1,8,8,0,0,0,0
1680751,2,1,10,8,2,0,2,0
1680751,3,1,9,9,0,1,1,1
1681459,1,1,19,12,7,0,7,6
1681459,2,1,15,7,8,0,8,8
1681459,3,1,0,0,0,0,0,0
1681459,4,1,0,0,0,0,0,0
1681860,1,1,0,0,0,0,0,0
1682859,1,1,4,4,0,0,0,0
1683097,1,1,9,3,6,0,6,6
1683097,2,1,0,0,0,0,0,0
1683160,1,1,1,6,-5,5,0,0
1683583,1,1,22,5,17,1,18,18
1683583,2,1,12,7,5,2,7,7
1684249,1,1,8,7,1,0,1,1
1684249,2,1,11,10,1,0,1,0
1684560,2,1,5,4,1,2,3,2
1684560,3,1,3,4,-1,2,1,1
1684560,5,1,6,6,0,1,1,1
1684637,1,1,6,6,0,0,0,0
1684637,2,1,10,15,-5,8,3,2
1684666,1,1,12,13,-1,5,4,0
1684666,2,1,13,11,2,4,6,5
1684737,1,1,10,8,2,2,4,3
1684737,4,1,1,2,-1,1,0,0
1684737,5,1,2,2,0,0,0,0
1684737,6,1,4,4,0,0,0,0
1684737,7,1,6,4,2,0,2,2
1684808,1,1,6,2,4,0,4,3
1684808,2,1,5,2,3,0,3,2
1684946,1,1,0,0,0,0,0,0
1684946,3,1,0,0,0,0,0,0
1685065,1,1,7,6,1,0,1,1
1685832,1,1,6,10,-4,4,0,0
1685832,2,1,3,3,0,0,0,0
1686056,1,1,5,7,-2,4,2,2
1686056,2,1,0,0,0,0,0,0
1687014,1,1,5,5,0,0,0,0
1687014,2,1,3,2,1,0,1,1
1687279,1,1,3,8,-5,5,0,0
1687430,1,1,8,6,2,0,2,2
1687769,2,1,9,9,0,1,1,1
1687769,3,1,4,4,0,0,0,0
1688439,1,1,1,6,-5,5,0,0
1688439,2,1,6,4,2,0,2,0
1688512,1,1,5,5,0,0,0,0
1688512,2,1,3,4,-1,1,0,0
1688881,1,1,6,6,0,0,0,0
1688949,1,1,0,0,0,0,0,0
1689250,1,1,12,11,1,0,1,0
1689250,2,1,18,1,17,0,17,1
1689250,3,1,4,2,2,0,2,2
1689508,1,1,3,3,0,0,0,0
1689508,2,1,10,8,2,0,2,2
1689638,1,1,6,4,2,0,2,2
1689782,1,1,2,2,0,0,0,0
1689993,1,1,3,2,1,0,1,0
1689993,2,1,3,4,-1,2,1,0
1690037,1,1,11,11,0,0,0,0
1690037,2,1,4,4,0,0,0,0
1690037,3,1,6,5,1,0,1,1
1690037,4,1,4,4,0,0,0,0
1690037,5,1,3,2,1,0,1,0
1690615,1,1,5,4,1,0,1,1
1690615,2,1,4,6,-2,2,0,0
1690633,1,1,4,7,-3,3,0,0
1690633,2,1,12,6,6,0,6,6
1690891,1,1,13,10,3,0,3,3
1690948,1,1,2,3,-1,1,0,0
1690974,1,1,4,4,0,0,0,0
1690974,2,1,2,2,0,0,0,0
1691222,1,1,7,2,5,0,5,3
1691222,3,1,2,3,-1,2,1,1
1691334,1,1,15,11,4,1,5,2
1691380,1,1,8,8,0,1,1,1
1691380,2,1,10,10,0,0,0,0
1691829,1,1,11,9,2,0,2,2
1691829,2,1,3,3,0,0,0,0
1691829,3,1,3,3,0,0,0,0
1692064,1,1,3,2,1,0,1,1
1692064,2,1,3,2,1,0,1,0
1692386,1,1,14,13,1,5,6,1
1692386,3,1,4,4,0,0,0,0
1692386,4,1,10,15,-5,6,1,1
1693156,1,1,4,2,2,0,2,2
1693156,2,1,4,4,0,0,0,0
1693168,1,1,0,0,0,0,0,0
1693168,2,1,14,13,1,2,3,2
1693996,1,1,3,4,-1,1,0,0
1693996,2,1,8,9,-1,1,0,0
1694090,1,1,6,7,-1,2,1,1
1694283,1,1,7,4,3,0,3,2
1695328,1,1,4,4,0,0,0,0
1695328,2,1,4,4,0,0,0,0
1696048,2,1,5,6,-1,1,0,0
1696493,1,1,2,2,0,1,1,1
1696493,2,1,3,2,1,0,1,1
1697454,1,1,6,5,1,0,1,1
1697502,1,1,12,11,1,0,1,1
1698427,1,1,2,2,0,0,0,0
1698427,2,1,0,0,0,0,0,0
1699060,1,1,10,10,0,1,1,1
1699060,2,1,14,17,-3,4,1,1
1699060,3,1,14,10,4,0,4,4
1699149,1,1,8,9,-1,1,0,0
1699149,2,1,0,0,0,0,0,0
1699149,3,1,2,2,0,0,0,0
1699217,1,1,5,5,0,0,0,0
1699217,2,1,5,5,0,0,0,0
1699217,3,1,7,7,0,0,0,0
1699366,1,1,4,6,-2,2,0,0
1699366,2,1,6,6,0,1,1,1
1699586,1,1,2,4,-2,2,0,0
1699908,1,1,12,6,6,1,7,0
1700777,1,1,6,6,0,1,1,1
1700777,2,1,6,6,0,1,1,1
1700785,1,1,10,13,-3,5,2,2
1700785,2,1,6,6,0,0,0,0
1700785,3,1,15,10,5,0,5,5
1701046,1,1,13,15,-2,3,1,1
1701046,2,1,7,6,1,0,1,1
1701046,3,1,11,10,1,2,3,1
1701187,1,1,0,0,0,0,0,0
1701275,1,1,4,6,-2,2,0,0
1701275,2,1,11,7,4,0,4,4
1701303,1,1,2,2,0,1,1,0
1701303,2,1,11,11,0,0,0,0
1702771,1,1,0,0,0,0,0,0
1704095,1,1,9,6,3,0,3,3
1704095,2,1,2,2,0,0,0,0
1704317,1,1,20,18,2,0,2,1
1704675,1,1,4,5,-1,1,0,0
1705458,1,1,3,3,0,0,0,0
1705458,2,1,7,5,2,0,2,2
1705458,3,1,0,0,0,0,0,0
1705458,4,1,7,5,2,0,2,2
1705519,1,1,2,2,0,0,0,0
1705519,2,1,14,9,5,0,5,4
1705626,1,1,13,10,3,1,4,4
1705626,2,1,1,7,-6,6,0,0
1706031,2,1,3,9,-6,6,0,0
1706031,3,1,7,5,2,1,3,3
1706031,4,1,10,11,-1,2,1,1
1706238,1,1,0,0,0,0,0,0
1706238,2,1,0,0,0,0,0,0
1706992,1,1,7,5,2,0,2,2
1706992,2,1,6,13,-7,7,0,0
1707483,1,1,4,3,1,0,1,1
1707483,2,1,2,6,-4,4,0,0
1707501,1,1,7,6,1,0,1,0
1707501,2,1,2,2,0,0,0,0
1707555,1,1,0,0,0,0,0,0
1707555,5,1,0,0,0,0,0,0
1708455,1,1,5,5,0,0,0,0
1708455,2,1,0,0,0,0,0,0
1708455,3,1,5,3,2,0,2,2
1708499,2,1,6,6,0,0,0,0
1708844,1,1,7,6,1,0,1,1
1708844,2,1,3,5,-2,2,0,0
1709013,1,1,16,13,3,0,3,1
1709013,2,1,6,7,-1,1,0,0
1709183,1,1,15,14,1,6,7,1
1709183,2,1,13,13,0,0,0,0
1709307,1,1,15,13,2,0,2,2
1709307,2,1,0,0,0,0,0,0
1709916,1,1,1,4,-3,3,0,0
1709916,2,1,6,7,-1,1,0,0
1710214,1,1,2,6,-4,4,0,0
1710214,2,1,10,4,6,0,6,5
1710433,1,1,9,10,-1,2,1,1
1710671,1,1,7,7,0,0,0,0
1711282,1,1,9,4,5,0,5,4
1711282,2,1,20,8,12,0,12,5
1711962,1,1,2,2,0,0,0,0
1712703,1,1,3,6,-3,3,0,0
1712703,2,1,8,7,1,1,2,2
1713667,1,1,6,5,1,0,1,1
1713667,2,1,4,4,0,0,0,0
1713667,3,1,5,5,0,0,0,0
1713709,1,1,7,5,2,0,2,2
1713709,2,1,16,17,-1,2,1,1
1714143,1,1,15,7,8,0,8,7
1714143,2,1,19,7,12,0,12,5
1714556,1,1,5,5,0,0,0,0
1714556,3,1,0,0,0,0,0,0
1714556,4,1,0,0,0,0,0,0
1714687,1,1,0,0,0,0,0,0
1714687,2,1,2,2,0,0,0,0
1714687,3,1,4,3,1,0,1,1
1714816,1,1,13,10,3,2,5,5
1714816,2,1,12,6,6,0,6,5
1715544,1,1,5,4,1,0,1,1
1715544,2,1,1,4,-3,3,0,0
1715544,3,1,4,2,2,0,2,0
1715593,1,1,6,5,1,0,1,0
1715619,1,1,10,9,1,0,1,1
1715632,1,1,9,7,2,4,6,6
1715632,2,1,2,9,-7,8,1,1
1716600,1,1,3,3,0,0,0,0
1716600,2,1,4,6,-2,2,0,0
1716600,3,1,8,4,4,0,4,1
1716600,4,1,3,3,0,0,0,0
1716890,1,1,1,9,-8,8,0,0
1716890,2,1,2,2,0,0,0,0
1717144,1,1,6,6,0,0,0,0
1717144,2,1,6,6,0,0,0,0
1717144,3,1,6,6,0,0,0,0
1717144,4,1,15,13,2,0,2,2
1717144,5,1,6,6,0,0,0,0
1717144,6,1,6,6,0,0,0,0
1717144,7,1,6,6,0,0,0,0
1717684,1,1,6,5,1,0,1,0
1717684,2,1,8,4,4,0,4,4
1717961,1,1,14,11,3,0,3,3
1719347,1,1,3,6,-3,3,0,0
1719347,2,1,7,6,1,0,1,1
1719658,1,1,2,6,-4,4,0,0
1720106,1,1,0,0,0,0,0,0
1720106,2,1,5,8,-3,3,0,0
1720168,2,1,12,13,-1,4,3,2
1720817,1,1,3,3,0,0,0,0
1720817,2,1,8,7,1,0,1,1
1720853,1,1,8,2,6,0,6,6
1720853,2,1,0,0,0,0,0,0
1721088,1,1,3,3,0,0,0,0
1721088,2,1,6,3,3,0,3,3
1721170,1,1,7,6,1,2,3,3
1721170,2,1,8,4,4,2,6,6
1721170,3,1,6,3,3,0,3,3
1722680,1,1,11,10,1,0,1,1
1722680,2,1,8,6,2,0,2,2
1722680,3,1,8,6,2,0,2,2
1722680,4,1,9,10,-1,2,1,1
1722971,1,1,11,9,2,4,6,5
1722971,2,1,0,0,0,0,0,0
1723134,1,1,0,0,0,0,0,0
1723134,2,1,8,7,1,0,1,1
1723228,1,1,4,9,-5,6,1,1
1723531,1,1,2,2,0,0,0,0
1724307,2,1,11,3,8,0,8,8
1724307,4,1,11,4,7,0,7,7
1724515,1,1,0,0,0,0,0,0
1725195,1,1,1,5,-4,4,0,0
1725195,2,1,10,7,3,0,3,3
1725617,1,1,0,0,0,0,0,0
1725617,2,1,2,8,-6,6,0,0
1725838,1,1,8,6,2,1,3,2
1726579,1,1,5,3,2,0,2,2
1726579,2,1,7,11,-4,4,0,0
1726675,1,1,5,2,3,0,3,3
1726675,2,1,5,4,1,1,2,2
1727085,1,1,0,0,0,0,0,0
1727085,2,1,0,0,0,0,0,0
1727250,1,1,0,0,0,0,0,0
1727250,2,1,2,4,-2,2,0,0
1727250,3,1,7,2,5,0,5,4
1727500,1,1,0,0,0,0,0,0
1727500,2,1,0,0,0,0,0,0
1727551,1,1,7,8,-1,3,2,1
1727673,1,1,12,8,4,1,5,1
1727673,2,1,9,6,3,0,3,3
1727678,1,1,7,3,4,1,5,3
1727678,2,1,4,3,1,2,3,2
1728072,1,1,2,2,0,0,0,0
1728072,2,1,3,3,0,0,0,0
1728072,3,1,4,4,0,0,0,0
1728108,1,1,3,3,0,0,0,0
1728108,2,1,11,10,1,0,1,0
1728229,1,1,6,4,2,0,2,1
1728229,2,1,5,5,0,0,0,0
1728988,1,1,8,10,-2,3,1,0
1728988,2,1,8,6,2,0,2,2
1729093,1,1,11,7,4,0,4,4
1729093,2,1,7,3,4,0,4,2
1729994,1,1,8,8,0,0,0,0
1729994,2,1,8,8,0,0,0,0
1730044,1,1,3,2,1,0,1,1
1730044,2,1,7,6,1,0,1,1
1730044,3,1,7,6,1,0,1,1
1730044,4,1,9,8,1,0,1,1
1730146,1,1,4,2,2,0,2,0
1730146,2,1,0,0,0,0,0,0
1730404,1,1,11,10,1,2,3,3
1730469,1,1,8,9,-1,1,0,0
1730469,2,1,3,7,-4,4,0,0
1730743,1,1,9,7,2,0,2,2
1730743,2,1,5,4,1,0,1,1
1730822,1,1,10,10,0,0,0,0
1730822,2,1,28,1,27,0,27,0
1730836,1,1,8,8,0,0,0,0
1730836,2,1,10,12,-2,3,1,1
1731036,1,1,13,10,3,0,3,2
1731190,1,1,3,4,-1,2,1,1
1731307,1,1,6,4,2,1,3,2
1731307,2,1,7,4,3,0,3,2
1732218,1,1,5,9,-4,4,0,0
1732218,2,1,10,10,0,0,0,0
1732227,1,1,15,21,-6,6,0,0
1732523,1,1,3,3,0,1,1,0
1732583,1,1,2,2,0,0,0,0
1732583,2,1,2,2,0,0,0,0
1732710,1,1,9,11,-2,5,3,2
1732722,1,1,0,0,0,0,0,0
1732899,1,1,8,6,2,1,3,3
1733548,1,1,8,8,0,0,0,0
1733548,2,1,3,3,0,0,0,0
1733915,1,1,18,14,4,0,4,4
1733915,2,1,15,10,5,1,6,6
1733952,1,1,17,17,0,2,2,2
1733952,2,1,19,6,13,1,14,14
1734216,1,1,2,2,0,0,0,0
1734216,2,1,3,3,0,0,0,0
1734603,1,1,11,10,1,1,2,2
1734603,2,1,9,7,2,0,2,2
1734603,3,1,7,4,3,0,3,3
1734606,1,1,7,5,2,0,2,2
1734621,1,1,8,5,3,0,3,2
1734621,2,1,3,3,0,1,1,0
1734652,1,1,2,2,0,0,0,0
1734657,1,1,20,13,7,0,7,7
1734657,2,1,5,13,-8,8,0,0
1734787,2,1,3,2,1,0,1,1
1735115,1,1,0,0,0,0,0,0
1735812,1,1,8,8,0,1,1,1
1735812,2,1,7,6,1,0,1,1
1735812,3,1,6,5,1,0,1,1
1735812,4,1,7,6,1,0,1,1
1736316,1,1,0,0,0,0,0,0
1736316,2,1,1,2,-1,1,0,0
1736316,3,1,17,15,2,0,2,1
1736492,1,1,11,8,3,1,4,4
1736942,1,1,15,9,6,0,6,6
1736942,2,1,13,9,4,0,4,4
1738463,2,1,7,2,5,1,6,6
1738808,2,1,7,6,1,0,1,1
1739070,1,1,13,17,-4,5,1,1
1739347,1,1,4,6,-2,2,0,0
1739347,2,1,4,4,0,0,0,0
1740789,1,1,4,4,0,0,0,0
1740878,1,1,4,4,0,0,0,0
1740930,1,1,8,8,0,0,0,0
1740930,2,1,21,6,15,0,15,1
1741523,1,1,2,2,0,0,0,0
1741523,2,1,11,6,5,0,5,3
1741546,1,1,6,6,0,4,4,2
1741741,1,1,20,17,3,0,3,2
1741741,2,1,22,11,11,1,12,11
1741741,3,1,0,0,0,0,0,0
1741799,1,1,5,4,1,0,1,1
1741799,2,1,3,2,1,0,1,1
1742107,1,1,12,8,4,0,4,1
1742107,2,1,15,11,4,0,4,4
1742204,1,1,2,2,0,0,0,0
1742204,2,1,6,5,1,0,1,0
1742204,3,1,4,5,-1,1,0,0
1742349,1,1,9,6,3,3,6,6
1742349,2,1,5,2,3,0,3,3
1742526,1,1,14,13,1,0,1,1
1742526,2,1,4,4,0,0,0,0
1742583,1,1,5,5,0,0,0,0
1742583,2,1,4,4,0,1,1,0
1742831,1,1,2,2,0,0,0,0
1742831,2,1,0,0,0,0,0,0
1743251,1,1,1,2,-1,1,0,0
1743251,2,1,7,7,0,0,0,0
1743251,3,1,4,4,0,0,0,0
1743363,1,1,1,2,-1,1,0,0
1743363,2,1,2,7,-5,5,0,0
1743369,1,1,0,0,0,0,0,0
1743369,3,1,4,2,2,0,2,2
1743491,1,1,4,5,-1,1,0,0
1743491,2,1,2,2,0,0,0,0
1743886,1,1,4,4,0,1,1,1
1744305,1,1,12,8,4,0,4,4
1744305,2,1,1,7,-6,6,0,0
1744305,3,1,5,7,-2,4,2,2
1744327,1,1,6,19,-13,13,0,0
1744327,2,1,5,6,-1,3,2,2
1744573,1,1,11,9,2,0,2,2
1744573,2,1,4,5,-1,1,0,0
1744670,1,1,10,8,2,0,2,0
1744670,2,1,4,3,1,0,1,0
1744743,1,1,3,5,-2,2,0,0
1744743,2,1,11,9,2,0,2,2
1744743,3,1,7,7,0,0,0,0
1744743,4,1,0,0,0,0,0,0
1745197,1,1,8,7,1,0,1,1
1745197,2,1,9,12,-3,3,0,0
1745399,1,1,0,0,0,0,0,0
1745399,2,1,0,0,0,0,0,0
1745494,1,1,9,8,1,0,1,1
1746215,2,1,3,4,-1,3,2,2
1746831,1,1,7,5,2,1,3,3
1746831,2,1,1,0,1,0,1,0
1747079,1,1,0,0,0,0,0,0
1747079,2,1,12,9,3,3,6,6
1747079,3,1,0,0,0,0,0,0
1747556,1,1,7,4,3,1,4,4
1747562,1,1,12,11,1,0,1,1
1747562,2,1,7,9,-2,2,0,0
1747562,3,1,4,4,0,0,0,0
1748481,1,1,10,10,0,0,0,0
1748481,2,1,2,4,-2,3,1,1
1748552,1,1,8,8,0,0,0,0
1748552,2,1,2,6,-4,4,0,0
1748949,1,1,11,10,1,0,1,1
1748964,1,1,3,3,0,0,0,0
1748964,2,1,5,5,0,0,0,0
1748964,3,1,0,0,0,0,0,0
1748996,1,1,15,13,2,0,2,2
1748996,3,1,2,2,0,0,0,0
1750710,1,1,9,3,6,0,6,6
1750710,2,1,11,4,7,0,7,7
1750710,3,1,0,0,0,0,0,0
1751114,2,1,4,3,1,0,1,1
1751114,3,1,2,2,0,0,0,0
1751194,1,1,3,12,-9,9,0,0
1751340,1,1,14,15,-1,1,0,0
1751340,3,1,8,7,1,1,2,2
1751703,1,1,2,4,-2,2,0,0
1751703,2,1,3,2,1,0,1,1
1751732,1,1,8,6,2,0,2,0
1751732,2,1,4,6,-2,2,0,0
1751732,3,1,10,8,2,3,5,5
1751980,1,1,9,5,4,0,4,2
1751980,2,1,13,11,2,0,2,2
1752133,1,1,9,7,2,0,2,2
1752133,2,1,3,2,1,0,1,0
1752192,1,1,14,1,13,0,13,8
1752192,2,1,5,1,4,0,4,3
1752628,1,1,7,4,3,0,3,3
1752923,1,1,15,6,9,0,9,5
1752923,2,1,0,0,0,0,0,0
1752923,3,1,14,10,4,0,4,1
1753343,1,1,0,0,0,0,0,0
1753402,1,1,0,0,0,0,0,0
1753402,2,1,2,2,0,0,0,0
1753402,4,1,2,2,0,0,0,0
1753969,1,1,3,3,0,0,0,0
1753969,2,1,14,13,1,0,1,0
1753969,3,1,14,13,1,0,1,1
1754866,2,1,6,2,4,0,4,4
1754866,3,1,7,2,5,0,5,5
1754929,1,1,5,4,1,0,1,1
1754929,2,1,1,4,-3,3,0,0
1755078,1,1,0,0,0,0,0,0
1755078,2,1,10,8,2,0,2,1
1755078,3,1,3,5,-2,2,0,0
1755078,4,1,8,5,3,0,3,0
1755199,1,1,7,7,0,0,0,0
1755199,2,1,5,6,-1,1,0,0
1755570,1,1,0,0,0,0,0,0
1755570,2,1,12,4,8,0,8,8
1755869,1,1,6,6,0,0,0,0
1756361,1,1,2,2,0,1,1,1
1756361,2,1,0,0,0,0,0,0
1756384,1,1,28,14,14,0,14,4
1756384,2,1,3,5,-2,2,0,0
1756488,1,1,9,9,0,0,0,0
1756488,2,1,19,12,7,0,7,0
1757022,1,1,7,7,0,0,0,0
1757022,2,1,4,6,-2,2,0,0
1757278,1,1,9,9,0,0,0,0
1757462,2,1,9,2,7,0,7,7
1757701,1,1,16,6,10,0,10,8
1758062,1,1,0,0,0,0,0,0
1758296,1,1,0,0,0,0,0,0
1758296,2,1,10,6,4,0,4,4
1758542,1,1,11,9,2,0,2,1
1758542,2,1,4,3,1,0,1,0
1758542,3,1,0,0,0,0,0,0
1758899,1,1,10,8,2,1,3,1
1758899,2,1,5,5,0,0,0,0
1759621,1,1,0,0,0,0,0,0
1759621,2,1,10,7,3,2,5,5
1759821,1,1,2,2,0,0,0,0
1759821,2,1,1,6,-5,5,0,0
1759906,1,1,2,2,0,0,0,0
1760113,1,1,28,2,26,0,26,26
1760113,2,1,0,0,0,0,0,0
1760140,1,1,1,6,-5,5,0,0
1760140,2,1,0,0,0,0,0,0
1760178,1,1,9,5,4,0,4,3
1760178,2,1,2,4,-2,2,0,0
1760804,1,1,0,0,0,0,0,0
1760804,2,1,0,0,0,0,0,0
1760965,1,1,7,5,2,0,2,2
1761035,1,1,2,2,0,0,0,0
1761035,2,1,0,0,0,0,0,0
1761307,1,1,6,6,0,0,0,0
1761307,2,1,2,2,0,0,0,0
1761539,1,1,8,8,0,0,0,0
1761539,2,1,8,8,0,0,0,0
1761539,3,1,1,12,-11,11,0,0
1761781,1,1,4,5,-1,3,2,2
1761961,1,1,18,13,5,0,5,5
1761961,3,1,2,2,0,0,0,0
1761961,4,1,6,3,3,0,3,3
1762523,1,1,6,6,0,2,2,0
1762605,1,1,14,13,1,0,1,1
1762605,2,1,9,6,3,1,4,4
1762605,3,1,14,8,6,0,6,6
1763295,1,1,10,4,6,0,6,5
1763371,1,1,11,18,-7,11,4,4
1763371,2,1,11,18,-7,10,3,3
1763564,1,1,2,2,0,0,0,0
1763564,2,1,3,3,0,0,0,0
1763564,3,1,2,2,0,0,0,0
1763738,1,1,4,4,0,0,0,0
1763738,2,1,11,5,6,0,6,6
1763771,1,1,14,5,9,0,9,4
1763771,2,1,11,5,6,0,6,1
1763822,1,1,5,6,-1,2,1,0
1763822,2,1,9,8,1,0,1,1
1763822,3,1,10,8,2,0,2,2
1763822,4,1,6,4,2,0,2,2
1763822,5,1,1,6,-5,5,0,0
1764022,1,1,2,4,-2,2,0,0
1764197,1,1,5,4,1,0,1,1
1764197,2,1,4,4,0,0,0,0
1764197,3,1,0,0,0,0,0,0
1764408,1,1,0,0,0,0,0,0
1764408,2,1,3,3,0,0,0,0
1764458,1,1,5,4,1,0,1,1
1764545,1,1,23,23,0,1,1,1
1764545,2,1,3,3,0,0,0,0
1764809,1,1,11,10,1,0,1,1
1765157,1,1,7,6,1,0,1,1
1765157,2,1,7,5,2,0,2,1
1765157,3,1,15,12,3,0,3,2
1765518,1,1,15,12,3,0,3,2
1765518,2,1,3,4,-1,2,1,1
1765859,1,1,10,4,6,0,6,6
1765859,2,1,7,6,1,1,2,2
1766068,1,1,2,3,-1,2,1,1
1766503,1,1,17,2,15,0,15,14
1766759,1,1,4,6,-2,2,0,0
1766759,2,1,6,8,-2,2,0,0
1767028,1,1,3,3,0,0,0,0
1767028,2,1,0,0,0,0,0,0
1767914,1,1,0,0,0,0,0,0
1767914,2,1,2,2,0,0,0,0
1767914,3,1,6,6,0,0,0,0
1768130,1,1,0,0,0,0,0,0
1768130,2,1,0,0,0,0,0,0
1768582,1,1,3,3,0,0,0,0
1768718,1,1,10,9,1,0,1,1
1768718,3,1,2,5,-3,3,0,0
1768718,4,1,0,0,0,0,0,0
1769154,1,1,1,1,0,0,0,0
1769154,2,1,8,9,-1,1,0,0
1769154,3,1,13,2,11,0,11,10
1769165,1,1,9,8,1,0,1,1
1769251,1,1,3,6,-3,3,0,0
1769567,1,1,1,2,-1,1,0,0
1769567,2,1,9,5,4,0,4,1
1769567,4,1,9,7,2,0,2,0
1769567,5,1,14,8,6,2,8,7
1769567,6,1,9,4,5,0,5,4
1769580,1,1,6,4,2,0,2,1
1769580,2,1,7,9,-2,2,0,0
1769580,3,1,5,3,2,0,2,2
1769938,1,1,6,9,-3,3,0,0
1769938,2,1,4,4,0,0,0,0
1769980,1,1,7,8,-1,2,1,1
1770374,1,1,0,0,0,0,0,0
1770595,1,1,5,4,1,0,1,1
1770595,2,1,9,9,0,0,0,0
1770595,3,1,6,7,-1,2,1,1
1770757,1,1,12,8,4,0,4,0
1770757,2,1,0,0,0,0,0,0
1771111,2,1,11,9,2,0,2,2
1771118,1,1,18,12,6,0,6,3
1771118,2,1,9,8,1,0,1,1
1771501,1,1,7,4,3,0,3,1
1771501,2,1,5,3,2,0,2,0
1771501,3,1,2,2,0,0,0,0
1771501,4,1,11,11,0,0,0,0
1771922,1,1,4,2,2,0,2,2
1772046,1,1,10,6,4,0,4,4
1772046,2,1,6,3,3,0,3,3
1772046,3,1,0,0,0,0,0,0
1772050,1,1,5,8,-3,3,0,0
1772050,2,1,17,12,5,0,5,5
1772050,4,1,12,6,6,0,6,5
1772290,1,1,14,14,0,1,1,0
1772290,2,1,3,2,1,0,1,1
1772923,1,1,7,6,1,0,1,1
1772923,2,1,10,10,0,3,3,3
1773097,1,1,0,0,0,0,0,0
1773247,1,1,5,5,0,0,0,0
1773375,1,1,8,3,5,0,5,1
1773375,2,1,6,2,4,0,4,2
1773411,1,1,3,6,-3,3,0,0
1773411,2,1,9,8,1,0,1,1
1773423,1,1,7,6,1,0,1,1
1773703,1,1,14,12,2,0,2,0
1773703,2,1,3,3,0,1,1,1
1774345,1,1,0,0,0,0,0,0
1774345,2,1,0,0,0,0,0,0
1774345,3,1,0,0,0,0,0,0
1774345,4,1,0,0,0,0,0,0
1774345,7,1,0,0,0,0,0,0
1774345,8,1,0,0,0,0,0,0
1774421,1,1,0,0,0,0,0,0
1774421,2,1,0,0,0,0,0,0
1774421,3,1,0,0,0,0,0,0
1775387,1,1,2,2,0,0,0,0
1775387,2,1,2,4,-2,2,0,0
1775387,3,1,2,4,-2,2,0,0
1775486,1,1,2,6,-4,4,0,0
1775486,2,1,6,6,0,0,0,0
1775551,1,1,4,7,-3,4,1,1
1775551,2,1,11,12,-1,1,0,0
1775999,1,1,15,14,1,1,2,2
1775999,2,1,10,10,0,0,0,0
1776317,1,1,6,4,2,0,2,2
1777223,1,1,6,5,1,0,1,1
1777223,2,1,0,0,0,0,0,0
1777291,1,1,4,2,2,0,2,2
1777291,2,1,4,2,2,0,2,2
1777740,1,1,0,0,0,0,0,0
1777740,2,1,0,0,0,0,0,0
1777740,3,1,0,0,0,0,0,0
1777834,1,1,5,5,0,0,0,0
1777834,2,1,13,16,-3,6,3,2
1778084,1,1,14,9,5,2,7,7
1778087,1,1,8,5,3,0,3,0
1780209,1,1,0,0,0,0,0,0
1780209,2,1,0,0,0,0,0,0
1783124,1,1,7,7,0,0,0,0
1783124,2,1,7,7,0,0,0,0
1783214,1,1,1,2,-1,1,0,0
1783214,2,1,2,8,-6,6,0,0
1783214,3,1,1,3,-2,2,0,0
1783241,1,1,2,2,0,0,0,0
1783304,1,1,4,4,0,0,0,0
1783534,1,1,8,8,0,0,0,0
1783578,1,1,12,13,-1,2,1,0
1783578,2,1,7,6,1,0,1,1
1783647,1,1,3,4,-1,1,0,0
1783647,2,1,0,0,0,0,0,0
1784066,1,1,17,17,0,3,3,1
1784066,2,1,2,4,-2,2,0,0
1784070,1,1,1,11,-10,10,0,0
1784577,1,1,3,3,0,0,0,0
1784577,2,1,6,6,0,0,0,0
1785138,1,1,4,6,-2,2,0,0
1785734,1,1,9,9,0,0,0,0
1786231,1,1,5,5,0,0,0,0
1786259,1,1,9,1,8,0,8,8
1786259,2,1,3,2,1,0,1,0
1786732,2,1,0,0,0,0,0,0
1786732,3,1,0,0,0,0,0,0
1786732,4,1,0,0,0,0,0,0
1786732,5,1,0,0,0,0,0,0
1787004,1,1,9,8,1,0,1,1
1787004,2,1,5,5,0,0,0,0
1787994,1,1,0,0,0,0,0,0
1787994,2,1,0,0,0,0,0,0
1787994,3,1,0,0,0,0,0,0
1788028,1,1,0,0,0,0,0,0
1788028,2,1,4,3,1,0,1,0
1788028,3,1,13,6,7,0,7,7
1788028,4,1,1,2,-1,1,0,0
1788028,5,1,17,2,15,1,16,0
1788230,1,1,14,9,5,0,5,5
1788695,1,1,3,2,1,0,1,1
1789086,1,1,6,6,0,0,0,0
1789086,2,1,0,0,0,0,0,0
1789764,1,1,2,2,0,0,0,0
1789764,2,1,3,2,1,0,1,0
1790388,1,1,6,5,1,0,1,0
1790388,2,1,9,7,2,0,2,0
1791018,1,1,9,5,4,0,4,4
1791018,2,1,5,3,2,1,3,3
1791018,3,1,6,4,2,0,2,2
1791671,1,1,3,4,-1,1,0,0
1791915,1,1,3,5,-2,4,2,2
1791915,2,1,7,12,-5,6,1,0
1792063,1,1,1,4,-3,3,0,0
1792063,2,1,0,0,0,0,0,0
1792268,1,1,7,7,0,0,0,0
1792268,2,1,3,2,1,0,1,1
1792492,1,1,8,4,4,2,6,3
1792738,1,1,3,2,1,0,1,1
1794619,1,1,8,6,2,0,2,2
1794619,2,1,4,3,1,0,1,1
1794696,1,1,12,3,9,0,9,9
1794696,2,1,9,1,8,0,8,8
1794696,3,1,7,4,3,2,5,5
1795294,1,1,6,4,2,1,3,3
1795294,2,1,9,9,0,0,0,0
1795444,1,1,16,12,4,0,4,3
1795444,2,1,3,2,1,0,1,1
1795610,1,1,2,2,0,0,0,0
1795610,2,1,2,2,0,0,0,0
1795969,1,1,9,11,-2,2,0,0
1796730,1,1,3,3,0,0,0,0
1796730,2,1,3,3,0,0,0,0
1796843,1,1,8,7,1,0,1,1
1796843,2,1,4,4,0,0,0,0
1797074,3,1,0,0,0,0,0,0
1797398,1,1,0,0,0,0,0,0
1797398,2,1,15,2,13,1,14,1
1798838,1,1,2,4,-2,2,0,0
1798838,2,1,5,2,3,0,3,3
1798838,3,1,4,3,1,1,2,2
1799359,1,1,15,20,-5,5,0,0
1799359,2,1,4,7,-3,3,0,0
1800633,1,1,7,7,0,0,0,0
1800633,2,1,9,9,0,4,4,4
1800923,1,1,1,2,-1,1,0,0
1800923,2,1,8,5,3,0,3,3
1800923,3,1,10,6,4,0,4,2
1801053,1,1,7,2,5,0,5,5
1801053,2,1,0,0,0,0,0,0
1801610,1,1,11,5,6,0,6,6
1801610,2,1,10,5,5,0,5,5
1801755,1,1,8,6,2,0,2,2
1801755,2,1,0,0,0,0,0,0
1801802,1,1,4,9,-5,6,1,1
1801802,2,1,7,5,2,0,2,2
1802077,1,1,4,6,-2,2,0,0
1802077,2,1,15,17,-2,3,1,1
1802077,3,1,10,2,8,0,8,0
1802085,1,1,15,7,8,0,8,3
1802085,2,1,3,4,-1,1,0,0
1802085,3,1,0,0,0,0,0,0
1802597,1,1,9,9,0,0,0,0
1802597,2,1,4,4,0,0,0,0
1803015,1,1,3,3,0,0,0,0
1803015,2,1,7,2,5,0,5,5
1803141,1,1,5,5,0,0,0,0
1803141,2,1,0,0,0,0,0,0
1803457,1,1,20,16,4,1,5,5
1803457,2,1,13,10,3,0,3,2
1803629,1,1,4,4,0,0,0,0
1803629,2,1,6,5,1,2,3,3
1803744,1,1,5,6,-1,4,3,3
1803744,2,1,0,0,0,0,0,0
1803744,3,1,10,2,8,0,8,8
1804207,1,1,1,6,-5,5,0,0
1804207,4,1,0,0,0,0,0,0
1804916,1,1,7,7,0,0,0,0
1804916,2,1,7,7,0,0,0,0
1804980,1,1,9,7,2,1,3,0
1804980,2,1,4,4,0,0,0,0
1805277,1,1,10,11,-1,1,0,0
1805277,2,1,7,7,0,0,0,0
1805277,3,1,10,7,3,0,3,2
1805302,1,1,2,2,0,0,0,0
1805302,2,1,8,8,0,0,0,0
1805302,3,1,6,4,2,0,2,2
1805302,4,1,16,11,5,0,5,2
1805598,1,1,4,4,0,0,0,0
1805598,2,1,2,2,0,0,0,0
1805893,1,1,5,4,1,0,1,1
1805893,2,1,2,3,-1,1,0,0
1805963,1,1,5,5,0,1,1,1
1806240,1,1,9,6,3,1,4,4
1806240,2,1,9,5,4,0,4,4
1806240,3,1,6,3,3,0,3,1
1807129,1,1,6,6,0,0,0,0
1807160,1,1,4,3,1,0,1,0
1807160,2,1,0,0,0,0,0,0
1807712,1,1,4,5,-1,2,1,1
1807929,1,1,2,2,0,0,0,0
1807929,2,1,15,8,7,1,8,8
1807929,3,1,11,6,5,0,5,5
1807933,1,1,10,4,6,1,7,5
1807933,2,1,3,2,1,0,1,1
1808824,1,1,3,3,0,0,0,0
1808824,2,1,0,0,0,0,0,0
1809226,1,1,6,2,4,0,4,1
1809226,2,1,17,8,9,0,9,8
1809226,3,1,11,6,5,0,5,5
1810301,1,1,8,7,1,0,1,1
1810301,2,1,7,7,0,1,1,1
1810301,3,1,6,5,1,0,1,1
1810330,1,1,5,4,1,0,1,1
1811061,1,1,9,8,1,0,1,0
1811061,2,1,3,5,-2,2,0,0
1811113,1,1,3,2,1,0,1,1
1811113,2,1,1,2,-1,1,0,0
1811113,3,1,0,0,0,0,0,0
1811113,4,1,22,14,8,5,13,13
1811148,1,1,3,6,-3,3,0,0
1811148,2,1,6,7,-1,3,2,2
1811718,1,1,6,7,-1,1,0,0
1811718,2,1,3,3,0,0,0,0
1812024,1,1,9,8,1,0,1,1
1812024,2,1,4,3,1,0,1,1
1812433,1,1,9,2,7,0,7,2
1812433,2,1,5,2,3,0,3,3
1812599,1,1,6,4,2,2,4,4
1812599,2,1,6,2,4,1,5,5
1812599,3,1,5,6,-1,1,0,0
1812930,1,1,7,3,4,0,4,4
1812930,2,1,1,3,-2,2,0,0
1813234,1,1,5,5,0,0,0,0
1813234,2,1,6,5,1,0,1,0
1814896,1,1,9,3,6,0,6,6
1814896,2,1,9,3,6,0,6,6
1815065,1,1,15,14,1,1,2,2
1815065,2,1,13,13,0,0,0,0
1815644,1,1,19,15,4,0,4,4
1816383,1,1,3,3,0,0,0,0
1816493,1,1,5,4,1,0,1,1
1816493,2,1,3,2,1,0,1,1
1817833,1,1,9,2,7,0,7,0
1818443,1,1,10,8,2,0,2,1
1818443,3,1,6,3,3,0,3,1
1818630,1,1,0,0,0,0,0,0
1818630,2,1,0,0,0,0,0,0
1818829,1,1,2,3,-1,1,0,0
1818876,1,1,6,4,2,0,2,2
1818876,2,1,6,6,0,0,0,0
1819093,1,1,6,3,3,1,4,4
1819093,2,1,5,5,0,1,1,1
1819392,1,1,5,7,-2,3,1,1
1819392,2,1,17,10,7,0,7,6
1819392,5,1,0,0,0,0,0,0
1819599,2,1,7,6,1,0,1,1
1820297,1,1,10,7,3,0,3,3
1820297,2,1,5,5,0,0,0,0
1820338,1,1,2,2,0,0,0,0
1820338,2,1,26,3,23,0,23,18
1820817,1,1,20,11,9,0,9,6
1820817,2,1,9,6,3,0,3,2
1820912,1,1,6,4,2,0,2,0
1820912,2,1,12,2,10,0,10,8
1821234,1,1,14,10,4,0,4,0
1821234,3,1,5,4,1,0,1,1
1821311,2,1,6,6,0,0,0,0
1821311,3,1,4,4,0,0,0,0
1821311,4,1,5,2,3,1,4,3
1822265,1,1,2,5,-3,3,0,0
1822265,2,1,3,3,0,0,0,0
1822816,1,1,6,5,1,2,3,3
1822816,2,1,5,6,-1,2,1,1
1822931,1,1,5,9,-4,4,0,0
1822931,2,1,3,7,-4,4,0,0
1823822,1,1,11,9,2,0,2,1
1823822,2,1,8,8,0,1,1,1
1823974,1,1,8,7,1,0,1,0
1824049,1,1,13,11,2,0,2,2
1824049,2,1,13,5,8,0,8,8
1824049,4,1,10,6,4,0,4,4
1824155,1,1,9,7,2,0,2,2
1824155,2,1,5,5,0,0,0,0
1824241,1,1,10,9,1,1,2,2
1824241,2,1,6,4,2,0,2,1
1824346,1,1,5,4,1,0,1,1
1824346,2,1,8,8,0,1,1,1
1824994,1,1,15,7,8,0,8,8
1824994,2,1,2,2,0,0,0,0
1825233,1,1,6,6,0,0,0,0
1825966,1,1,0,0,0,0,0,0
1825966,2,1,4,3,1,0,1,0
1826338,1,1,3,2,1,0,1,1
1826338,2,1,3,2,1,0,1,0
1826774,1,1,3,3,0,0,0,0
1827459,1,1,3,3,0,0,0,0
1829150,2,1,19,10,9,4,13,0
1829150,3,1,2,4,-2,2,0,0
1831028,1,1,3,2,1,1,2,2
1831028,2,1,6,4,2,0,2,0
1831219,1,1,2,2,0,0,0,0
1831219,2,1,4,4,0,0,0,0
1831736,1,1,7,2,5,0,5,5
1831736,2,1,5,4,1,0,1,1
1832032,1,1,17,14,3,2,5,5
1832032,2,1,2,2,0,0,0,0
1832032,3,1,13,12,1,4,5,5
1832087,1,1,7,7,0,0,0,0
1832087,2,1,5,5,0,0,0,0
1832087,3,1,7,5,2,0,2,2
1832190,1,1,4,4,0,0,0,0
1832410,1,1,5,5,0,0,0,0
1832668,1,1,13,14,-1,4,3,3
1832668,2,1,4,3,1,1,2,2
1832669,1,1,6,6,0,0,0,0
1832669,2,1,0,0,0,0,0,0
1832669,3,1,6,6,0,1,1,0
1832890,1,1,8,8,0,0,0,0
1832890,2,1,2,2,0,0,0,0
1833487,1,1,4,3,1,0,1,1
1833487,2,1,10,5,5,0,5,5
1833804,1,1,13,13,0,2,2,2
1833804,2,1,8,8,0,1,1,1
1833804,3,1,3,2,1,0,1,1
1834630,1,1,4,4,0,0,0,0
1834630,2,1,4,2,2,0,2,1
1835101,1,1,2,3,-1,1,0,0
1835107,1,1,3,3,0,0,0,0
1835107,2,1,0,0,0,0,0,0
1835107,3,1,12,9,3,0,3,3
1835230,1,1,6,5,1,0,1,0
1835230,3,1,2,10,-8,8,0,0
1835872,2,1,0,0,0,0,0,0
1836175,1,1,0,0,0,0,0,0
1836175,2,1,0,0,0,0,0,0
1836603,1,1,5,5,0,0,0,0
1836603,2,1,0,0,0,0,0,0
1836678,2,1,10,9,1,3,4,3
1836898,1,1,0,0,0,0,0,0
1837121,1,1,4,3,1,0,1,0
1837121,2,1,3,3,0,1,1,0
1837364,1,1,9,9,0,2,2,2
1837364,2,1,10,9,1,1,2,2
1838355,1,1,10,7,3,0,3,3
1838355,2,1,0,0,0,0,0,0
1838666,1,1,0,0,0,0,0,0
1838819,1,1,13,10,3,0,3,0
1838819,2,1,4,4,0,1,1,1
1839114,1,1,3,3,0,0,0,0
1839114,2,1,3,3,0,0,0,0
1839389,1,1,4,4,0,0,0,0
1839389,2,1,1,3,-2,2,0,0
1840179,1,1,0,0,0,0,0,0
1840179,2,1,0,0,0,0,0,0
1840740,1,1,12,5,7,0,7,7
1840740,2,1,8,7,1,0,1,1
1840740,3,1,34,3,31,0,31,7
1840850,1,1,9,3,6,0,6,6
1840850,2,1,1,3,-2,2,0,0
1841188,1,1,3,2,1,0,1,1
1842745,1,1,5,9,-4,5,1,1
1842745,2,1,7,5,2,0,2,2
1843482,1,1,5,5,0,0,0,0
1843482,2,1,3,3,0,0,0,0
1843485,1,1,4,3,1,0,1,0
1843485,2,1,5,5,0,1,1,1
1843488,1,1,5,5,0,1,1,1
1843488,2,1,0,0,0,0,0,0
1843830,1,1,2,4,-2,2,0,0
1843830,2,1,0,0,0,0,0,0
1844032,1,1,9,9,0,3,3,3
1844032,2,1,6,6,0,0,0,0
1844422,1,1,12,11,1,0,1,0
1844422,2,1,2,2,0,0,0,0
1844423,1,1,7,7,0,0,0,0
1844423,2,1,2,2,0,0,0,0
1844423,3,1,1,4,-3,3,0,0
1844423,4,1,0,0,0,0,0,0
1844423,5,1,4,4,0,0,0,0
1844478,1,1,5,5,0,0,0,0
1844478,2,1,0,0,0,0,0,0
1844478,3,1,0,0,0,0,0,0
1844706,1,1,13,11,2,0,2,0
1844706,2,1,15,10,5,4,9,9
1844706,3,1,7,8,-1,2,1,1
1846117,1,1,2,3,-1,2,1,0
1846117,4,1,3,4,-1,3,2,2
1846670,1,1,12,8,4,0,4,0
1846670,2,1,1,2,-1,1,0,0
1846670,3,1,5,5,0,0,0,0
1846670,4,1,18,12,6,0,6,4
1846953,1,1,5,5,0,0,0,0
1847157,1,1,8,3,5,0,5,2
1847407,1,1,11,8,3,2,5,5
1847407,3,1,2,2,0,0,0,0
1847470,1,1,2,6,-4,4,0,0
1847470,2,1,14,2,12,0,12,2
1847470,3,1,4,4,0,0,0,0
1847518,1,1,9,6,3,0,3,0
1847518,2,1,5,5,0,0,0,0
1847518,3,1,4,9,-5,5,0,0
1848571,1,1,1,4,-3,3,0,0
1848571,2,1,0,0,0,0,0,0
1848704,1,1,2,2,0,0,0,0
1848704,2,1,4,2,2,0,2,2
1849627,1,1,6,5,1,0,1,1
1850240,1,1,2,7,-5,5,0,0
1850240,2,1,8,9,-1,2,1,1
1850716,1,1,7,7,0,0,0,0
1850716,3,1,6,5,1,0,1,1
1850776,1,1,2,2,0,0,0,0
1850776,2,1,8,3,5,0,5,2
1851306,1,1,4,8,-4,5,1,1
1851306,2,1,3,5,-2,2,0,0
1851654,1,1,6,9,-3,3,0,0
1851654,2,1,3,4,-1,1,0,0
1851654,3,1,10,10,0,0,0,0
1851654,4,1,10,10,0,0,0,0
1852083,1,1,10,7,3,1,4,3
1852083,2,1,7,2,5,0,5,5
1852433,1,1,2,4,-2,2,0,0
1852433,2,1,1,2,-1,1,0,0
1852874,1,1,0,0,0,0,0,0
1852874,2,1,7,6,1,1,2,2
1852924,1,1,4,4,0,0,0,0
1852924,2,1,0,0,0,0,0,0
1853245,1,1,1,4,-3,3,0,0
1853245,2,1,12,9,3,2,5,3
1853245,3,1,2,4,-2,2,0,0
1853688,1,1,4,3,1,0,1,1
1853688,2,1,15,7,8,0,8,8
1853688,3,1,7,5,2,0,2,2
1853690,1,1,2,2,0,0,0,0
1853690,2,1,4,5,-1,1,0,0
1853690,3,1,3,4,-1,1,0,0
1853690,4,1,2,2,0,0,0,0
1854348,1,1,8,10,-2,3,1,1
1854348,2,1,2,4,-2,2,0,0
1854837,1,1,5,5,0,0,0,0
1854837,2,1,0,0,0,0,0,0
1855026,1,1,2,3,-1,1,0,0
1855026,2,1,0,0,0,0,0,0
1855480,1,1,5,5,0,0,0,0
1855480,2,1,8,7,1,0,1,0
1856044,1,1,8,5,3,0,3,1
1856062,1,1,9,9,0,0,0,0
1856297,1,1,18,14,4,9,13,10
1856297,2,1,11,8,3,0,3,2
1856297,3,1,3,3,0,0,0,0
1856297,4,1,3,3,0,0,0,0
1856445,1,1,6,6,0,0,0,0
1857798,2,1,11,5,6,0,6,6
1857901,1,1,5,11,-6,6,0,0
1857901,2,1,10,10,0,0,0,0
1858373,1,1,6,6,0,0,0,0
1858373,2,1,6,6,0,2,2,2
1858426,1,1,4,4,0,0,0,0
1858426,2,1,2,7,-5,5,0,0
1858504,1,1,12,11,1,0,1,1
1858504,2,1,1,5,-4,4,0,0
1859081,1,1,9,8,1,0,1,1
1859081,2,1,5,4,1,0,1,1
1859129,1,1,4,6,-2,2,0,0
1859129,2,1,8,2,6,0,6,6
1859855,1,1,6,2,4,0,4,4
1859855,2,1,6,6,0,0,0,0
1859855,3,1,0,0,0,0,0,0
1859855,4,1,7,3,4,0,4,4
1860362,1,1,6,6,0,0,0,0
1860362,2,1,7,5,2,1,3,3
1860489,1,1,12,11,1,0,1,1
1860489,2,1,13,13,0,0,0,0
1861039,1,1,3,2,1,0,1,0
1861039,2,1,0,0,0,0,0,0
1861097,3,1,4,2,2,0,2,2
1861097,4,1,4,2,2,0,2,2
1861132,1,1,8,4,4,0,4,1
1861132,2,1,17,4,13,0,13,6
1861132,3,1,1,8,-7,7,0,0
1861407,2,1,16,12,4,2,6,6
1861407,3,1,15,9,6,2,8,7
1861449,1,1,0,0,0,0,0,0
1861575,1,1,6,6,0,3,3,0
1861575,2,1,7,6,1,1,2,2
1861958,1,1,12,8,4,0,4,4
1861958,2,1,5,5,0,1,1,0
1862113,1,1,13,11,2,0,2,2
1862113,2,1,5,5,0,0,0,0
1862188,1,1,0,0,0,0,0,0
1862218,1,1,5,5,0,0,0,0
1862218,2,1,7,6,1,0,1,1
1862258,1,1,6,6,0,1,1,1
1862258,2,1,2,2,0,0,0,0
1862258,3,1,2,2,0,1,1,1
1862258,4,1,12,5,7,0,7,4
1862296,1,1,6,6,0,0,0,0
1862296,2,1,0,0,0,0,0,0
1862338,1,1,8,4,4,0,4,4
1862338,2,1,4,2,2,0,2,0
1862576,1,1,3,2,1,0,1,1
1862576,2,1,8,5,3,3,6,4
1862576,3,1,3,8,-5,5,0,0
1862576,4,1,30,10,20,0,20,20
1862835,1,1,10,9,1,0,1,0
1862835,2,1,7,2,5,0,5,2
1862835,3,1,6,9,-3,3,0,0
1863465,1,1,9,11,-2,2,0,0
1863465,2,1,4,12,-8,8,0,0
1863465,3,1,0,0,0,0,0,0
1863465,4,1,9,9,0,0,0,0
1864062,1,1,2,3,-1,1,0,0
1864192,1,1,3,3,0,0,0,0
1864192,2,1,6,4,2,0,2,1
1864490,1,1,4,4,0,0,0,0
1864490,2,1,4,4,0,0,0,0
1864544,1,1,8,4,4,0,4,4
1864544,2,1,14,5,9,0,9,7
1864544,3,1,6,4,2,0,2,2
1865312,1,1,9,2,7,0,7,7
1865603,2,1,11,8,3,0,3,1
1866416,1,1,4,6,-2,2,0,0
1866553,1,1,8,6,2,0,2,2
1866553,2,1,7,6,1,0,1,0
1866580,1,1,2,5,-3,3,0,0
1866580,2,1,6,8,-2,5,3,3
1866895,1,1,3,2,1,0,1,1
1867185,1,1,2,2,0,0,0,0
1867185,2,1,2,2,0,0,0,0
1867413,1,1,5,2,3,1,4,4
1867507,1,1,10,9,1,0,1,0
1868081,1,1,4,3,1,0,1,1
1868081,2,1,8,8,0,0,0,0
1868152,2,1,3,3,0,0,0,0
1868152,3,1,2,4,-2,2,0,0
1868152,4,1,2,2,0,0,0,0
1868226,1,1,11,13,-2,2,0,0
1868226,2,1,2,4,-2,2,0,0
1868436,1,1,7,4,3,0,3,2
1868501,1,1,9,8,1,0,1,0
1869748,1,1,0,0,0,0,0,0
1869748,2,1,0,0,0,0,0,0
1869748,3,1,0,0,0,0,0,0
1869748,4,1,0,0,0,0,0,0
1869748,5,1,0,0,0,0,0,0
1870037,1,1,22,13,9,0,9,9
1870419,1,1,7,8,-1,1,0,0
1870439,1,1,5,2,3,0,3,2
1870530,1,1,2,2,0,0,0,0
1870530,2,1,4,4,0,3,3,3
1870728,1,1,6,6,0,0,0,0
1870728,2,1,12,10,2,0,2,2
1870728,3,1,3,3,0,0,0,0
1870841,1,1,5,5,0,0,0,0
1870841,2,1,8,8,0,0,0,0
1870841,3,1,9,9,0,0,0,0
1871017,1,1,1,10,-9,9,0,0
1871017,2,1,4,5,-1,2,1,1
1871579,1,1,4,4,0,0,0,0
1871728,1,1,4,4,0,0,0,0
1871728,2,1,3,4,-1,2,1,0
1872323,1,1,6,6,0,0,0,0
1872323,2,1,1,0,1,0,1,0
1872947,1,1,4,4,0,0,0,0
1873699,1,1,3,2,1,0,1,1
1873699,2,1,0,0,0,0,0,0
1873728,1,1,7,7,0,0,0,0
1873740,1,1,0,0,0,0,0,0
1873740,2,1,0,0,0,0,0,0
1874065,1,1,5,8,-3,4,1,1
1874065,2,1,8,8,0,0,0,0
1874245,1,1,1,3,-2,2,0,0
1874245,2,1,8,6,2,0,2,1
1874375,2,1,2,2,0,0,0,0
1874375,3,1,2,2,0,0,0,0
1875397,1,1,9,9,0,0,0,0
1875397,2,1,3,4,-1,1,0,0
1875523,1,1,7,8,-1,3,2,2
1875523,2,1,19,16,3,0,3,1
1876270,1,1,0,0,0,0,0,0
1876270,2,1,0,0,0,0,0,0
1876604,1,1,12,4,8,0,8,7
1876604,2,1,12,7,5,0,5,5
1876604,3,1,23,11,12,0,12,12
1877252,1,1,3,5,-2,2,0,0
1877252,2,1,2,3,-1,1,0,0
1877316,1,1,8,7,1,0,1,0
1877316,2,1,11,10,1,0,1,1
1877547,1,1,13,9,4,0,4,4
1877547,2,1,4,2,2,0,2,2
1878606,1,1,3,3,0,0,0,0
1878866,1,1,9,7,2,0,2,1
1878866,2,1,6,6,0,1,1,0
1879404,1,1,0,0,0,0,0,0
1879404,2,1,0,0,0,0,0,0
1879450,1,1,15,9,6,0,6,1
1879543,1,1,11,11,0,0,0,0
1879543,2,1,5,4,1,0,1,1
1880103,1,1,6,6,0,0,0,0
1880135,1,1,2,2,0,0,0,0
1880135,2,1,0,0,0,0,0,0
1880665,1,1,3,2,1,0,1,1
1880665,2,1,4,4,0,0,0,0
1881205,1,1,9,2,7,0,7,6
1881813,1,1,6,9,-3,3,0,0
1881813,2,1,0,0,0,0,0,0
1882557,1,1,3,3,0,0,0,0
1882557,2,1,0,0,0,0,0,0
1883022,1,1,2,2,0,0,0,0
1883022,2,1,4,4,0,0,0,0
1883934,1,1,2,4,-2,2,0,0
1883934,2,1,10,11,-1,2,1,1
1883961,1,1,10,9,1,0,1,1
1884501,1,1,9,5,4,0,4,4
1884501,2,1,13,6,7,0,7,7
1884839,1,1,12,11,1,0,1,0
1885105,1,1,12,11,1,2,3,1
1885105,2,1,12,11,1,1,2,0
1885105,5,1,7,5,2,1,3,2
1886117,1,1,5,4,1,0,1,0
1886295,2,1,5,2,3,1,4,2
1886378,1,1,6,5,1,0,1,0
1886380,1,1,5,5,0,0,0,0
1886380,2,1,5,4,1,0,1,1
1886380,3,1,3,2,1,0,1,1
1886648,1,1,15,11,4,0,4,4
1886648,2,1,13,8,5,2,7,6
1886693,1,1,2,2,0,0,0,0
1886693,2,1,0,0,0,0,0,0
1887460,1,1,4,6,-2,2,0,0
1887700,1,1,8,8,0,0,0,0
1887700,2,1,6,6,0,0,0,0
1887895,1,1,7,7,0,0,0,0
1888035,1,1,10,11,-1,1,0,0
1888035,2,1,1,3,-2,2,0,0
1888132,1,1,11,8,3,0,3,3
1888132,2,1,5,6,-1,3,2,2
1888132,3,1,0,0,0,0,0,0
1888132,4,1,10,4,6,0,6,5
1888275,1,1,14,10,4,0,4,4
1888275,2,1,4,4,0,0,0,0
1888275,3,1,4,3,1,0,1,1
1888375,1,1,12,7,5,0,5,2
1888375,2,1,6,4,2,0,2,1
1888813,1,1,4,2,2,0,2,2
1889086,1,1,5,5,0,0,0,0
1889086,2,1,2,2,0,1,1,1
1889268,1,1,4,4,0,0,0,0
1890511,1,1,5,5,0,0,0,0
1890511,2,1,5,5,0,0,0,0
1890703,1,1,4,4,0,0,0,0
1890703,2,1,7,7,0,0,0,0
1891320,1,1,4,7,-3,4,1,1
1891331,1,1,6,4,2,0,2,0
1891331,2,1,10,3,7,2,9,0
1893111,1,1,7,7,0,0,0,0
1893998,1,1,7,4,3,0,3,0
1894347,1,1,14,11,3,1,4,2
1894347,2,1,9,9,0,0,0,0
1895174,1,1,1,0,1,0,1,0
1895174,2,1,1,2,-1,1,0,0
1895174,3,1,3,2,1,0,1,1
1895174,4,1,4,2,2,0,2,2
1895198,1,1,10,10,0,0,0,0
1895198,2,1,3,5,-2,3,1,1
1895284,1,1,5,4,1,1,2,2
1895284,2,1,9,7,2,0,2,2
1895284,3,1,0,0,0,0,0,0
1895341,1,1,4,4,0,0,0,0
1895341,2,1,13,8,5,0,5,5
1896009,2,1,5,5,0,0,0,0
1896078,1,1,12,9,3,0,3,3
1896127,1,1,10,4,6,0,6,0
1896127,2,1,6,6,0,0,0,0
1896127,3,1,0,0,0,0,0,0
1896127,4,1,10,5,5,0,5,5
1896133,1,1,6,3,3,0,3,3
1897324,1,1,8,3,5,0,5,0
1897805,1,1,5,7,-2,3,1,0
1897805,2,1,0,0,0,0,0,0
1897869,1,1,6,4,2,0,2,2
1898304,1,1,12,9,3,0,3,3
1898304,2,1,12,6,6,0,6,4
1898314,1,1,5,5,0,0,0,0
1898314,2,1,17,13,4,0,4,3
1898379,1,1,4,4,0,0,0,0
1898379,2,1,8,7,1,0,1,1
1898865,1,1,8,8,0,0,0,0
1898865,2,1,8,8,0,1,1,1
1898895,1,1,3,3,0,0,0,0
1899208,1,1,17,8,9,0,9,9
1899208,2,1,2,2,0,0,0,0
1899208,3,1,9,4,5,1,6,4
1899669,1,1,11,8,3,0,3,3
1899669,3,1,0,0,0,0,0,0
1899852,1,1,16,7,9,0,9,6
1899852,2,1,16,10,6,0,6,6
1900120,1,1,6,2,4,0,4,4
1900120,2,1,6,2,4,0,4,4
1900406,1,1,5,1,4,0,4,2
1900653,1,1,7,3,4,0,4,4
1900653,2,1,6,3,3,0,3,1
1901626,1,1,3,3,0,0,0,0
1901626,2,1,10,6,4,2,6,6
1901695,1,1,8,5,3,0,3,3
1901695,2,1,4,5,-1,2,1,1
1902105,1,1,5,5,0,0,0,0
1902105,2,1,11,5,6,0,6,6
1902105,3,1,3,2,1,0,1,1
1902105,4,1,10,2,8,0,8,8
1902190,1,1,0,0,0,0,0,0
1902190,2,1,0,0,0,0,0,0
1902213,1,1,0,0,0,0,0,0
1902213,2,1,7,7,0,0,0,0
1902628,1,1,5,4,1,0,1,1
1902628,2,1,7,6,1,0,1,1
1902628,3,1,7,7,0,0,0,0
1902889,1,1,6,6,0,0,0,0
1902889,2,1,0,0,0,0,0,0
1902889,5,1,4,4,0,0,0,0
1903076,1,1,2,2,0,0,0,0
1903076,2,1,0,0,0,0,0,0
1903315,1,1,9,9,0,0,0,0
1903315,2,1,10,8,2,0,2,2
1903524,1,1,0,0,0,0,0,0
1903524,2,1,7,5,2,0,2,2
1903532,2,1,0,0,0,0,0,0
1903532,4,1,8,7,1,0,1,1
1904222,1,1,3,4,-1,2,1,1
1904347,1,1,8,10,-2,2,0,0
1904347,3,1,5,4,1,0,1,1
1904755,1,1,10,10,0,0,0,0
1905059,1,1,9,11,-2,2,0,0
1905059,2,1,2,2,0,0,0,0
1905415,1,1,2,2,0,0,0,0
1905415,2,1,0,0,0,0,0,0
1906086,1,1,8,6,2,0,2,2
1906086,2,1,5,4,1,0,1,1
1906374,1,1,5,9,-4,4,0,0
1906374,2,1,1,10,-9,9,0,0
1906413,1,1,3,3,0,0,0,0
1906413,2,1,0,0,0,0,0,0
1906455,1,1,4,3,1,0,1,1
1908202,1,1,4,4,0,0,0,0
1908202,2,1,4,3,1,0,1,0
1908256,1,1,4,4,0,2,2,2
1908256,2,1,0,0,0,0,0,0
1908468,1,1,4,4,0,0,0,0
1908468,2,1,10,4,6,0,6,6
1908855,1,1,3,2,1,1,2,0
1908855,2,1,3,2,1,0,1,0
1908937,1,1,2,2,0,0,0,0
1908937,2,1,2,2,0,0,0,0
1909133,1,1,2,11,-9,9,0,0
1909133,2,1,12,8,4,0,4,4
1909247,1,1,3,2,1,0,1,1
1909247,2,1,2,2,0,0,0,0
1909247,3,1,4,2,2,0,2,0
1910592,1,1,2,4,-2,2,0,0
1910592,2,1,12,4,8,0,8,8
1910777,1,1,5,8,-3,3,0,0
1910777,2,1,6,6,0,0,0,0
1910977,1,1,4,4,0,0,0,0
1910977,2,1,0,0,0,0,0,0
1911175,1,1,5,5,0,0,0,0
1911175,2,1,6,6,0,0,0,0
1911224,1,1,3,3,0,0,0,0
1911224,2,1,6,6,0,1,1,0
1911679,1,1,5,4,1,0,1,1
1911679,2,1,5,6,-1,1,0,0
1911679,3,1,0,0,0,0,0,0
1911685,1,1,10,7,3,0,3,1
1911685,2,1,2,13,-11,11,0,0
1911738,1,1,0,0,0,0,0,0
1911738,2,1,15,5,10,0,10,3
1911786,1,1,2,11,-9,9,0,0
1912085,1,1,5,5,0,0,0,0
1912276,1,1,10,9,1,0,1,0
1912276,2,1,9,7,2,0,2,1
1912458,1,1,13,8,5,0,5,5
1912458,2,1,1,2,-1,1,0,0
1912517,1,1,10,10,0,0,0,0
1912517,2,1,2,2,0,0,0,0
1912597,1,1,3,2,1,0,1,1
1912597,2,1,2,2,0,0,0,0
1912597,3,1,8,2,6,0,6,6
1912597,4,1,10,2,8,0,8,5
1912760,1,1,3,1,2,0,2,2
1912760,2,1,3,7,-4,6,2,2
1912760,3,1,2,3,-1,1,0,0
1913749,1,1,7,4,3,0,3,3
1913924,1,1,4,4,0,0,0,0
1913924,2,1,2,4,-2,2,0,0
1914879,1,1,0,0,0,0,0,0
1914879,2,1,3,8,-5,5,0,0
1914879,3,1,0,0,0,0,0,0
1914879,4,1,0,0,0,0,0,0
1914918,1,1,7,6,1,0,1,1
1914918,2,1,12,7,5,0,5,3
1915096,1,1,5,4,1,0,1,1
1915096,2,1,8,4,4,0,4,4
1915247,1,1,4,4,0,0,0,0
1915247,2,1,4,6,-2,2,0,0
1915701,1,1,6,6,0,0,0,0
1915701,2,1,8,7,1,0,1,1
1915701,3,1,8,10,-2,2,0,0
1915701,4,1,17,10,7,2,9,9
1915901,1,1,7,7,0,0,0,0
1916436,1,1,3,2,1,0,1,1
1916436,2,1,9,6,3,0,3,3
1916481,1,1,3,3,0,0,0,0
1916481,2,1,2,2,0,0,0,0
1917034,1,1,7,4,3,1,4,4
1917034,2,1,6,3,3,0,3,3
1918923,1,1,6,6,0,0,0,0
1918923,2,1,9,8,1,0,1,1
1919177,1,1,3,6,-3,3,0,0
1919539,1,1,3,9,-6,6,0,0
1919539,2,1,1,6,-5,5,0,0
1919791,1,1,7,5,2,0,2,1
1919791,2,1,7,6,1,0,1,1
1920239,1,1,2,2,0,0,0,0
1921291,1,1,8,8,0,0,0,0
1921291,2,1,4,4,0,0,0,0
1922464,1,1,10,10,0,2,2,2
1922486,1,1,6,6,0,0,0,0
1922486,2,1,3,3,0,0,0,0
1922495,1,1,11,11,0,0,0,0
1922495,2,1,2,7,-5,5,0,0
1922608,1,1,4,6,-2,2,0,0
1924344,1,1,3,3,0,0,0,0
1924344,2,1,0,0,0,0,0,0
1924453,2,1,2,2,0,0,0,0
1924753,1,1,4,14,-10,10,0,0
1924753,2,1,2,2,0,0,0,0
1924878,1,1,0,0,0,0,0,0
1924878,2,1,0,0,0,0,0,0
1924878,3,1,9,7,2,0,2,2
1925081,1,1,9,8,1,0,1,0
1925372,1,1,3,6,-3,4,1,1
1925372,4,1,16,4,12,1,13,11
1925636,1,1,8,10,-2,2,0,0
1925636,2,1,5,5,0,0,0,0
1925786,1,1,7,8,-1,1,0,0
1925786,2,1,6,7,-1,1,0,0
1925786,3,1,2,4,-2,2,0,0
1925786,4,1,5,5,0,0,0,0
1925811,1,1,8,9,-1,3,2,1
1926189,1,1,3,2,1,0,1,1
1926189,2,1,3,3,0,0,0,0
1926244,1,1,10,9,1,2,3,0
1926244,2,1,5,11,-6,6,0,0
1926397,1,1,8,8,0,0,0,0
1926397,2,1,0,0,0,0,0,0
1926503,2,1,15,11,4,0,4,3
1926816,1,1,16,16,0,2,2,1
1926816,2,1,8,7,1,0,1,1
1926884,1,1,8,4,4,0,4,4
1926884,2,1,1,2,-1,1,0,0
1928414,1,1,0,0,0,0,0,0
1928414,2,1,5,6,-1,1,0,0
1928414,3,1,4,4,0,0,0,0
1928813,1,1,8,6,2,0,2,2
1928813,2,1,3,2,1,0,1,1
1928813,3,1,3,5,-2,2,0,0
1929207,1,1,4,8,-4,4,0,0
1929207,2,1,0,0,0,0,0,0
1929207,3,1,2,2,0,0,0,0
1929207,4,1,7,4,3,0,3,3
1929441,1,1,8,5,3,0,3,3
1929524,1,1,6,5,1,1,2,2
1929524,2,1,6,6,0,1,1,1
1929524,3,1,0,0,0,0,0,0
1929524,4,1,4,2,2,0,2,2
1929767,1,1,0,0,0,0,0,0
1929767,2,1,0,0,0,0,0,0
1929767,3,1,0,0,0,0,0,0
1929916,1,1,3,5,-2,2,0,0
1930525,1,1,5,6,-1,1,0,0
1930525,3,1,0,0,0,0,0,0
1930988,1,1,10,11,-1,2,1,1
1930988,3,1,6,6,0,0,0,0
1930988,4,1,9,4,5,0,5,5
1931074,2,1,5,4,1,1,2,2
1931074,3,1,18,13,5,0,5,5
1931074,4,1,14,8,6,0,6,6
1931629,1,1,2,2,0,0,0,0
1931629,2,1,0,0,0,0,0,0
1931629,3,1,0,0,0,0,0,0
1931857,1,1,2,4,-2,3,1,1
1931857,2,1,2,2,0,0,0,0
1931862,1,1,3,2,1,0,1,0
1931862,2,1,1,2,-1,1,0,0
1932253,1,1,5,2,3,0,3,3
1932253,2,1,13,4,9,0,9,9
1932253,3,1,5,6,-1,5,4,4
1933151,1,1,0,0,0,0,0,0
1933151,2,1,5,5,0,0,0,0
1933151,3,1,5,4,1,0,1,1
1933969,1,1,4,5,-1,2,1,1
1933969,2,1,1,2,-1,1,0,0
1933969,4,1,2,8,-6,7,1,0
1934818,1,1,9,3,6,0,6,6
1934818,2,1,5,6,-1,1,0,0
1934959,1,1,6,5,1,0,1,1
1934959,2,1,2,9,-7,7,0,0
1934959,3,1,9,7,2,0,2,2
1935177,1,1,6,7,-1,2,1,1
1935951,1,1,18,8,10,0,10,10
1935951,2,1,5,5,0,0,0,0
1936018,1,1,5,2,3,0,3,2
1936068,1,1,4,2,2,0,2,2
1936068,2,1,6,2,4,0,4,3
1936556,1,1,6,4,2,0,2,1
1936556,2,1,7,6,1,0,1,1
1937380,1,1,3,3,0,0,0,0
1937539,1,1,4,4,0,2,2,2
1937613,1,1,1,9,-8,8,0,0
1937613,2,1,6,14,-8,8,0,0
1937613,3,1,5,5,0,0,0,0
1937732,2,1,1,4,-3,3,0,0
1937840,1,1,0,0,0,0,0,0
1937840,2,1,0,0,0,0,0,0
1938073,1,1,1,2,-1,1,0,0
1938073,2,1,2,2,0,0,0,0
1938807,1,1,2,3,-1,1,0,0
1938807,2,1,4,6,-2,3,1,1
1939112,1,1,5,4,1,0,1,1
1939112,2,1,8,10,-2,3,1,1
1939112,3,1,10,4,6,0,6,6
1939112,4,1,12,5,7,0,7,7
1939267,1,1,15,15,0,0,0,0
1939267,2,1,18,10,8,0,8,7
1939702,1,1,0,0,0,0,0,0
1939702,2,1,4,4,0,1,1,1
1939898,1,1,1,2,-1,1,0,0
1939898,2,1,2,6,-4,4,0,0
1940564,1,1,6,2,4,0,4,4
1940607,1,1,9,7,2,1,3,3
1940607,3,1,0,0,0,0,0,0
1940749,1,1,7,7,0,0,0,0
1941157,1,1,5,5,0,0,0,0
1941157,2,1,2,8,-6,6,0,0
1941157,3,1,6,8,-2,2,0,0
1941336,1,1,12,11,1,0,1,1
1941336,2,1,7,4,3,1,4,4
1942229,1,1,8,5,3,0,3,2
1942229,2,1,8,6,2,3,5,4
1942244,1,1,6,6,0,0,0,0
1942376,1,1,9,6,3,0,3,3
1942376,2,1,6,3,3,0,3,2
1942390,1,1,5,5,0,0,0,0
1942390,2,1,7,5,2,0,2,0
1942759,1,1,7,4,3,0,3,3
1942821,1,1,9,4,5,0,5,5
1942821,2,1,0,0,0,0,0,0
1942930,1,1,8,8,0,1,1,1
1942930,2,1,10,8,2,1,3,1
1943391,1,1,6,6,0,0,0,0
1943450,1,1,7,7,0,0,0,0
1943450,2,1,0,0,0,0,0,0
1943585,1,1,2,4,-2,2,0,0
1943585,2,1,1,2,-1,1,0,0
1944655,1,1,4,2,2,0,2,2
1945506,1,1,10,8,2,0,2,1
1945506,2,1,6,5,1,0,1,0
1945949,1,1,11,12,-1,1,0,0
1945949,2,1,8,7,1,0,1,1
1945975,1,1,4,5,-1,1,0,0
1947163,1,1,4,3,1,0,1,1
1947494,1,1,3,2,1,0,1,1
1947494,2,1,5,8,-3,4,1,1
1947494,3,1,15,7,8,0,8,6
1947494,4,1,15,7,8,0,8,6
1947504,1,1,5,4,1,0,1,1
1947504,2,1,1,5,-4,4,0,0
1947816,1,1,8,9,-1,1,0,0
1948026,2,1,0,0,0,0,0,0
1948105,1,1,5,6,-1,2,1,0
1948105,2,1,12,9,3,0,3,3
1948177,1,1,10,7,3,0,3,3
1948177,2,1,2,2,0,0,0,0
1949573,1,1,8,5,3,3,6,6
1949573,2,1,6,2,4,0,4,4
1949746,1,1,24,4,20,0,20,0
1949746,2,1,6,3,3,0,3,0
1949746,3,1,0,0,0,0,0,0
1949907,1,1,7,12,-5,6,1,1
1950282,1,1,6,3,3,0,3,3
1950282,2,1,0,0,0,0,0,0
1950554,1,1,10,9,1,0,1,1
1950554,2,1,5,6,-1,2,1,1
1950600,1,1,8,7,1,0,1,0
1950600,2,1,3,3,0,0,0,0
1950609,1,1,6,6,0,0,0,0
1950609,2,1,12,7,5,0,5,4
1951510,1,1,9,5,4,1,5,2
1951510,2,1,10,5,5,0,5,2
1951581,1,1,9,10,-1,4,3,3
1952387,1,1,3,2,1,0,1,1
1952633,1,1,9,6,3,0,3,3
1952633,2,1,0,0,0,0,0,0
1952633,3,1,3,3,0,0,0,0
1952633,4,1,7,7,0,0,0,0
1952763,1,1,0,0,0,0,0,0
1952763,2,1,7,7,0,0,0,0
1953109,1,1,4,6,-2,4,2,0
1953109,3,1,2,4,-2,3,1,1
1953460,1,1,0,0,0,0,0,0
1953460,2,1,0,0,0,0,0,0
1953460,4,1,0,0,0,0,0,0
1953728,1,1,12,14,-2,2,0,0
1953728,2,1,11,10,1,0,1,0
1954062,1,1,7,10,-3,6,3,2
1954433,1,1,8,9,-1,1,0,0
1954433,2,1,6,5,1,0,1,1
1954813,1,1,4,4,0,0,0,0
1954813,2,1,16,14,2,2,4,4
1954973,1,1,6,7,-1,1,0,0
1955233,1,1,6,6,0,0,0,0
1955233,2,1,9,9,0,0,0,0
1955449,1,1,3,4,-1,2,1,1
1955449,2,1,2,2,0,0,0,0
1956176,1,1,5,5,0,0,0,0
1956176,2,1,8,7,1,0,1,0
1956182,1,1,0,0,0,0,0,0
1956540,1,1,9,9,0,0,0,0
1956919,1,1,13,13,0,1,1,1
1956919,2,1,7,2,5,0,5,5
1956919,3,1,4,8,-4,4,0,0
1957733,1,1,5,5,0,0,0,0
1957733,2,1,12,9,3,0,3,1
1957896,1,1,3,7,-4,4,0,0
1958029,1,1,2,2,0,0,0,0
1958147,1,1,7,7,0,1,1,1
1958147,2,1,22,10,12,2,14,14
1958147,3,1,9,2,7,0,7,7
1958391,1,1,7,4,3,0,3,3
1958391,2,1,9,5,4,0,4,3
1959857,1,1,14,10,4,0,4,4
1960857,2,1,4,4,0,0,0,0
1961067,1,1,8,6,2,0,2,1
1961067,2,1,4,3,1,0,1,0
1961193,1,1,4,4,0,0,0,0
1961193,2,1,11,8,3,0,3,3
1961193,3,1,5,5,0,0,0,0
1961297,1,1,8,8,0,0,0,0
1961297,2,1,3,5,-2,2,0,0
1961397,1,1,2,3,-1,1,0,0
1961397,2,1,10,10,0,2,2,2
1961397,3,1,3,3,0,0,0,0
1961824,1,1,0,0,0,0,0,0
1961824,2,1,0,0,0,0,0,0
1961824,3,1,0,0,0,0,0,0
1961915,1,1,3,2,1,0,1,1
1961937,1,1,1,2,-1,1,0,0
1961937,2,1,6,6,0,0,0,0
1962228,1,1,3,2,1,0,1,1
1962228,2,1,7,5,2,1,3,3
1962281,1,1,8,9,-1,1,0,0
1962281,2,1,12,12,0,0,0,0
1962464,1,1,9,6,3,0,3,3
1963757,1,1,5,7,-2,2,0,0
1963757,2,1,2,2,0,0,0,0
1963977,1,1,0,0,0,0,0,0
1963977,2,1,0,0,0,0,0,0
1964666,1,1,5,3,2,0,2,1
1964832,1,1,6,6,0,1,1,1
1964832,2,1,0,0,0,0,0,0
1965740,1,1,6,5,1,3,4,3
1965740,2,1,11,9,2,4,6,5
1966685,1,1,9,8,1,1,2,2
1967577,1,1,8,8,0,3,3,3
1968151,1,1,4,4,0,3,3,3
1968151,2,1,0,0,0,0,0,0
1968166,1,1,0,0,0,0,0,0
1968166,2,1,2,4,-2,2,0,0
1968293,1,1,0,0,0,0,0,0
1968293,2,1,0,0,0,0,0,0
1969045,1,1,8,7,1,0,1,1
1969045,2,1,3,3,0,0,0,0
1969045,3,1,11,8,3,0,3,3
1969244,1,1,2,5,-3,3,0,0
1969244,2,1,5,8,-3,3,0,0
1969425,1,1,0,0,0,0,0,0
1969737,1,1,7,6,1,4,5,5
1969737,4,1,2,4,-2,2,0,0
1969806,1,1,6,6,0,0,0,0
1969818,1,1,0,0,0,0,0,0
1969818,2,1,5,4,1,1,2,2
1969872,1,1,6,6,0,0,0,0
1970926,1,1,2,2,0,0,0,0
1970926,2,1,3,2,1,0,1,0
1970948,1,1,6,2,4,0,4,0
1971030,1,1,4,10,-6,6,0,0
1971030,2,1,0,0,0,0,0,0
1971163,1,1,10,9,1,0,1,0
1971163,2,1,4,3,1,0,1,1
1971550,1,1,4,4,0,0,0,0
1973274,1,1,14,10,4,0,4,3
1973648,1,1,0,0,0,0,0,0
1973648,2,1,0,0,0,0,0,0
1973648,3,1,5,4,1,0,1,1
1973832,1,1,7,7,0,0,0,0
1973832,2,1,2,2,0,0,0,0
1973966,1,1,4,2,2,0,2,2
1974023,1,1,0,0,0,0,0,0
1974023,2,1,2,2,0,0,0,0
1974789,1,1,7,7,0,0,0,0
1974956,1,1,8,8,0,1,1,1
1974956,2,1,7,11,-4,4,0,0
1974956,3,1,7,4,3,0,3,3
1974956,4,1,10,10,0,0,0,0
1974999,1,1,3,4,-1,2,1,1
1974999,2,1,5,4,1,0,1,1
1975233,1,1,4,12,-8,9,1,0
1975233,2,1,4,10,-6,6,0,0
1975269,1,1,5,5,0,0,0,0
1975269,2,1,5,5,0,0,0,0
1975427,1,1,0,0,0,0,0,0
1975427,2,1,0,0,0,0,0,0
1975531,1,1,8,7,1,1,2,0
1975531,2,1,7,7,0,0,0,0
1975627,1,1,1,5,-4,4,0,0
1975682,1,1,8,8,0,0,0,0
1975682,2,1,3,3,0,0,0,0
1975682,3,1,0,0,0,0,0,0
1975682,4,1,7,11,-4,5,1,1
1976261,1,1,4,4,0,0,0,0
1976261,2,1,2,2,0,0,0,0
1977792,1,1,7,7,0,4,4,3
1979159,1,1,7,12,-5,5,0,0
1979159,2,1,8,8,0,0,0,0
1979188,1,1,3,3,0,0,0,0
1979188,2,1,5,4,1,0,1,0
1979508,1,1,10,7,3,0,3,2
1979508,2,1,2,3,-1,1,0,0
1980240,1,1,9,9,0,0,0,0
1980240,2,1,2,5,-3,3,0,0
1980359,1,1,10,7,3,0,3,1
1980648,1,1,6,6,0,0,0,0
1980648,2,1,2,3,-1,1,0,0
1980648,3,1,7,3,4,0,4,4
1981040,1,1,15,10,5,0,5,0
1981480,1,1,0,0,0,0,0,0
1981480,2,1,0,0,0,0,0,0
1981480,3,1,0,0,0,0,0,0
1981597,1,1,9,8,1,1,2,2
1981677,1,1,12,5,7,0,7,4
1981712,1,1,4,4,0,0,0,0
1981973,1,1,4,2,2,0,2,2
1981973,3,1,16,2,14,0,14,3
1982027,1,1,5,10,-5,6,1,0
1982027,2,1,7,6,1,0,1,0
1982173,1,1,11,4,7,0,7,3
1982173,2,1,3,6,-3,5,2,1
1982198,1,1,2,3,-1,1,0,0
1982198,2,1,0,0,0,0,0,0
1982268,1,1,9,6,3,0,3,3
1982268,2,1,7,6,1,0,1,0
1982441,1,1,16,13,3,0,3,3
1982588,1,1,4,4,0,0,0,0
1982876,1,1,12,11,1,0,1,1
1982908,1,1,4,5,-1,1,0,0
1983033,1,1,5,5,0,0,0,0
1983696,1,1,2,2,0,0,0,0
1983696,2,1,4,4,0,0,0,0
1985002,1,1,13,7,6,0,6,0
1985002,2,1,11,9,2,0,2,2
1985002,3,1,11,7,4,0,4,4
1985228,1,1,2,2,0,0,0,0
1985228,2,1,22,15,7,0,7,7
1986829,1,1,16,3,13,0,13,13
1986829,2,1,9,7,2,0,2,1
1986829,3,1,0,0,0,0,0,0
1986829,4,1,12,3,9,1,10,10
1986888,1,1,4,4,0,0,0,0
1987242,1,1,0,0,0,0,0,0
1987242,2,1,10,9,1,0,1,1
1987242,3,1,0,0,0,0,0,0
1987242,4,1,2,2,0,0,0,0
1987589,1,1,12,11,1,0,1,1
1987589,2,1,1,2,-1,1,0,0
1988769,1,1,4,2,2,0,2,2
1988769,2,1,1,2,-1,1,0,0
1990215,1,1,7,5,2,0,2,0
1990271,3,1,0,0,0,0,0,0
1991080,1,1,4,4,0,1,1,1
1991080,2,1,3,2,1,0,1,1
1991496,1,1,6,3,3,1,4,4
1991496,4,1,0,0,0,0,0,0
1991693,1,1,8,4,4,0,4,0
1991693,2,1,12,9,3,0,3,3
1991761,1,1,10,8,2,0,2,1
1991761,2,1,4,4,0,0,0,0
1991761,3,1,5,4,1,0,1,1
1992966,1,1,7,7,0,0,0,0
1992966,2,1,17,7,10,0,10,10
1993019,1,1,19,19,0,1,1,1
1993019,2,1,8,6,2,0,2,2
1993019,3,1,8,6,2,1,3,0
1993187,1,1,10,9,1,0,1,1
1993187,2,1,6,9,-3,3,0,0
1993932,1,1,3,2,1,0,1,1
1994200,2,1,6,3,3,0,3,3
1994222,1,1,2,4,-2,2,0,0
1994222,2,1,13,11,2,0,2,2
1995124,1,1,4,6,-2,2,0,0
1995231,1,1,2,2,0,0,0,0
1995231,2,1,0,0,0,0,0,0
1995231,3,1,3,2,1,0,1,0
1995252,1,1,8,6,2,2,4,2
1995252,2,1,3,2,1,0,1,1
1995266,1,1,3,4,-1,1,0,0
1995266,2,1,5,5,0,0,0,0
1995266,3,1,6,5,1,1,2,1
1995279,1,1,9,9,0,0,0,0
1995279,2,1,6,7,-1,1,0,0
1995585,1,1,9,5,4,0,4,4
1995585,2,1,7,6,1,1,2,0
1995830,1,1,5,5,0,0,0,0
1995830,2,1,7,6,1,0,1,1
1995975,1,1,2,2,0,0,0,0
1995975,2,1,5,5,0,0,0,0
1996296,1,1,2,2,0,0,0,0
1996296,2,1,11,9,2,0,2,0
1996507,1,1,3,2,1,0,1,1
1996507,2,1,9,7,2,0,2,2
1996770,2,1,0,0,0,0,0,0
1996884,1,1,6,4,2,0,2,2
1997250,1,1,0,0,0,0,0,0
1997446,1,1,4,4,0,0,0,0
1997446,2,1,7,9,-2,3,1,1
1997768,1,1,9,4,5,0,5,5
1998037,1,1,12,8,4,0,4,4
1998286,1,1,10,9,1,0,1,1
1998286,2,1,3,2,1,0,1,0
1998312,1,1,4,2,2,0,2,1
1998312,2,1,3,2,1,0,1,0
1998704,1,1,17,3,14,0,14,1
1998704,2,1,3,2,1,0,1,1
1998704,3,1,3,2,1,0,1,1
1999394,1,1,12,6,6,1,7,1
1999394,3,1,11,6,5,0,5,1
1999732,1,1,0,0,0,0,0,0
1999732,2,1,3,3,0,0,0,0
2000040,1,1,4,4,0,0,0,0
2000040,2,1,0,0,0,0,0,0
2001499,1,1,4,3,1,0,1,0
2001499,2,1,0,0,0,0,0,0
2001537,1,1,4,4,0,0,0,0
2001537,2,1,5,2,3,0,3,3
2001921,1,1,11,9,2,0,2,2
2001921,2,1,11,10,1,0,1,0
2002018,1,1,11,5,6,0,6,6
2002018,2,1,11,6,5,0,5,5
2002018,3,1,14,6,8,0,8,8
2002107,1,1,3,8,-5,5,0,0
2002107,2,1,7,8,-1,1,0,0
2002167,1,1,2,2,0,0,0,0
2003127,1,1,8,4,4,0,4,4
2003127,2,1,8,4,4,0,4,4
2003127,3,1,8,4,4,2,6,6
2003382,1,1,2,4,-2,2,0,0
2003382,2,1,8,7,1,0,1,0
2003382,4,1,2,2,0,0,0,0
2003721,1,1,2,2,0,0,0,0
2003777,1,1,10,10,0,3,3,3
2004574,1,1,4,4,0,0,0,0
2004574,2,1,12,9,3,0,3,0
2004789,1,1,8,6,2,1,3,2
2004863,1,1,15,10,5,0,5,1
2004863,2,1,8,3,5,0,5,5
2004976,1,1,3,7,-4,4,0,0
2004976,2,1,15,14,1,0,1,1
2006191,1,1,9,5,4,0,4,2
2006421,1,1,0,0,0,0,0,0
2007237,1,1,0,0,0,0,0,0
2007237,2,1,2,2,0,0,0,0
2007237,4,1,0,0,0,0,0,0
2007245,1,1,0,0,0,0,0,0
2007441,1,1,8,6,2,0,2,0
2007441,2,1,9,5,4,0,4,0
2008196,1,1,4,4,0,0,0,0
2008196,2,1,7,6,1,0,1,1
2008801,1,1,21,10,11,0,11,9
2008801,2,1,9,5,4,0,4,4
2009457,1,1,9,4,5,0,5,3
2009457,2,1,11,8,3,1,4,4
2010524,1,1,6,4,2,0,2,2
2010685,1,1,17,14,3,0,3,0
2010685,2,1,8,6,2,0,2,0
2010685,3,1,5,5,0,0,0,0
2010685,4,1,16,9,7,0,7,2
2010685,5,1,8,6,2,0,2,1
2010685,6,1,15,6,9,0,9,7
2010685,7,1,0,0,0,0,0,0
2010799,1,1,8,2,6,0,6,5
2010799,2,1,8,2,6,0,6,5
2011024,1,1,9,7,2,0,2,2
2012384,1,1,5,7,-2,3,1,1
2012384,2,1,3,3,0,2,2,0
2013266,1,1,5,7,-2,4,2,0
2013442,1,1,3,3,0,0,0,0
2013442,2,1,0,0,0,0,0,0
2013827,1,1,10,10,0,0,0,0
2013827,2,1,7,6,1,0,1,1
2013968,1,1,7,8,-1,1,0,0
2014183,1,1,10,10,0,0,0,0
2014183,2,1,11,11,0,0,0,0
2014238,1,1,9,8,1,0,1,0
2014396,1,1,8,8,0,2,2,2
2014396,2,1,10,7,3,0,3,1
2014948,1,1,4,4,0,0,0,0
2014948,2,1,5,7,-2,2,0,0
2014949,1,1,7,7,0,0,0,0
2015280,1,1,6,8,-2,2,0,0
2015280,2,1,2,15,-13,13,0,0
2015371,1,1,4,5,-1,1,0,0
2015371,3,1,4,4,0,0,0,0
2015371,4,1,5,4,1,1,2,1
2016874,1,1,14,9,5,0,5,3
2016874,2,1,6,4,2,0,2,0
2017561,1,1,3,4,-1,1,0,0
2017561,2,1,3,4,-1,1,0,0
2017885,1,1,12,6,6,1,7,1
2017885,2,1,2,2,0,0,0,0
2019292,1,1,18,7,11,0,11,11
2019292,2,1,20,7,13,0,13,12
2019713,1,1,6,3,3,2,5,5
2019713,2,1,0,0,0,0,0,0
2020057,1,1,1,2,-1,1,0,0
2020057,2,1,2,2,0,0,0,0
2020552,1,1,7,7,0,0,0,0
2020552,2,1,0,0,0,0,0,0
2020886,1,1,4,4,0,0,0,0
2020886,2,1,6,6,0,0,0,0
2020889,1,1,7,12,-5,5,0,0
2020889,2,1,7,11,-4,5,1,1
2021002,1,1,3,4,-1,2,1,1
2021002,2,1,15,11,4,0,4,4
2021002,3,1,11,11,0,3,3,3
2021009,1,1,1,4,-3,3,0,0
2021009,2,1,19,9,10,0,10,8
2021256,1,1,3,3,0,0,0,0
2021256,2,1,9,12,-3,3,0,0
2021256,3,1,5,5,0,0,0,0
2021256,4,1,4,2,2,0,2,2
2021375,1,1,5,4,1,0,1,1
2021375,2,1,8,8,0,1,1,0
2022046,1,1,4,4,0,0,0,0
2022046,2,1,10,6,4,0,4,1
2022046,3,1,8,9,-1,1,0,0
2022134,1,1,5,8,-3,5,2,1
2022134,2,1,10,3,7,0,7,1
2022431,1,1,2,2,0,0,0,0
2022431,2,1,0,0,0,0,0,0
2022431,3,1,13,2,11,0,11,0
2022720,1,1,4,4,0,0,0,0
2022720,2,1,8,8,0,2,2,0
2022720,3,1,0,0,0,0,0,0
2022720,4,1,5,3,2,0,2,2
2022806,1,1,8,7,1,0,1,1
2022827,1,1,5,6,-1,1,0,0
2022827,2,1,3,4,-1,1,0,0
2023097,1,1,13,9,4,1,5,5
2023097,2,1,12,9,3,0,3,3
2023097,3,1,8,4,4,0,4,4
2023645,1,1,4,5,-1,1,0,0
2024088,1,1,0,0,0,0,0,0
2024088,2,1,0,0,0,0,0,0
2024103,1,1,2,2,0,0,0,0
2024103,2,1,16,7,9,0,9,2
2024417,1,1,0,0,0,0,0,0
2024417,2,1,0,0,0,0,0,0
2024493,1,1,9,10,-1,1,0,0
2024493,2,1,2,3,-1,1,0,0
2024494,1,1,8,5,3,0,3,0
2024494,2,1,8,5,3,0,3,2
2025090,1,1,8,7,1,0,1,0
2025090,2,1,8,8,0,1,1,1
2025090,3,1,24,8,16,2,18,2
2025270,1,1,9,9,0,0,0,0
2025270,2,1,3,4,-1,1,0,0
2027342,1,1,14,13,1,0,1,1
2027390,1,1,5,4,1,0,1,0
2028330,1,1,0,0,0,0,0,0
2028330,2,1,0,0,0,0,0,0
2028610,1,1,16,11,5,0,5,0
2028610,2,1,6,11,-5,5,0,0
2028610,3,1,13,11,2,2,4,2
2028610,4,1,13,10,3,0,3,0
2039824,1,1,3,8,-5,5,0,0
2039824,2,1,2,2,0,0,0,0
2042967,1,1,10,7,3,0,3,2
2042967,2,1,4,4,0,0,0,0
2044278,1,1,6,3,3,0,3,2
2044278,2,1,6,4,2,2,4,4
2045693,1,1,4,11,-7,7,0,0
2045693,2,1,11,11,0,0,0,0
2046577,1,1,5,2,3,1,4,4
2046577,2,1,17,14,3,0,3,3
2051970,1,1,6,4,2,0,2,1
2051970,2,1,10,9,1,0,1,1
2052069,1,1,4,4,0,2,2,2
2052821,1,1,5,4,1,0,1,1
2052821,2,1,8,8,0,0,0,0
2054493,1,1,7,6,1,0,1,1
2054718,1,1,3,3,0,0,0,0
2054718,2,1,4,3,1,0,1,1
2058384,1,1,4,5,-1,3,2,2
2060863,1,1,6,11,-5,5,0,0
2060901,1,1,2,2,0,0,0,0
2061905,1,1,8,5,3,2,5,4
2061905,2,1,0,0,0,0,0,0
2066556,2,1,0,0,0,0,0,0
2066556,3,1,15,4,11,1,12,10
2066622,2,1,2,2,0,0,0,0
2068649,1,1,4,4,0,0,0,0
2077130,1,1,3,3,0,0,0,0
2078526,1,1,2,2,0,0,0,0
2078526,2,1,0,0,0,0,0,0
2078607,1,1,5,4,1,0,1,1
2081560,1,1,3,3,0,0,0,0
2085953,1,1,9,10,-1,1,0,0
2085953,2,1,3,5,-2,2,0,0
2086017,1,1,8,6,2,0,2,2
2086017,2,1,2,2,0,0,0,0
2090898,1,1,5,5,0,0,0,0
2090898,2,1,3,7,-4,4,0,0
2090898,3,1,9,8,1,0,1,1
2102240,1,1,8,4,4,0,4,4
2102240,2,1,3,5,-2,2,0,0
2103160,1,1,3,2,1,0,1,1
2106883,1,1,15,16,-1,2,1,1
2106883,2,1,9,9,0,0,0,0
2108917,1,1,7,6,1,0,1,1
2108917,2,1,3,3,0,0,0,0
2109025,1,1,12,11,1,0,1,0
2109025,2,1,7,2,5,0,5,5
2109188,1,1,5,4,1,0,1,1
2110511,1,1,9,5,4,0,4,2
2110511,3,1,9,5,4,0,4,2
2111012,1,1,12,12,0,2,2,1
2111012,2,1,18,6,12,0,12,2
2114027,1,1,2,7,-5,5,0,0
2115859,1,1,6,6,0,0,0,0
2115859,2,1,6,6,0,0,0,0
2120309,1,1,5,5,0,0,0,0
2120464,1,1,3,3,0,0,0,0
2120464,2,1,5,3,2,0,2,2
2120738,1,1,4,4,0,0,0,0
2120738,2,1,9,4,5,1,6,6
2120815,1,1,4,4,0,0,0,0
2120836,1,1,7,7,0,0,0,0
2120851,1,1,3,3,0,0,0,0
2120851,2,1,7,4,3,0,3,3
2120881,1,1,2,2,0,0,0,0
2120881,2,1,3,3,0,0,0,0
2120897,1,1,4,4,0,0,0,0
2120897,2,1,7,4,3,0,3,3
2120966,1,1,12,10,2,0,2,1
2121029,1,1,0,0,0,0,0,0
2121029,2,1,5,4,1,0,1,0
2121651,1,1,7,4,3,0,3,3
2121651,2,1,4,8,-4,4,0,0
2121657,1,1,9,5,4,0,4,4
2121657,2,1,6,2,4,0,4,1
2121960,1,1,11,9,2,0,2,0
2121960,2,1,5,7,-2,2,0,0
2122181,1,1,11,9,2,0,2,2
2122181,2,1,0,0,0,0,0,0
2122181,3,1,1,4,-3,3,0,0
2122496,1,1,11,10,1,0,1,1
2122496,2,1,7,7,0,0,0,0
2122541,1,1,6,6,0,0,0,0
2122541,2,1,4,6,-2,3,1,1
2122901,1,1,10,6,4,0,4,0
2122901,2,1,6,7,-1,1,0,0
2122901,3,1,6,6,0,0,0,0
2122901,4,1,7,7,0,0,0,0
2123256,1,1,3,2,1,0,1,0
2123256,2,1,3,2,1,0,1,0
2123868,1,1,8,7,1,0,1,1
2123991,1,1,0,0,0,0,0,0
2123991,2,1,2,6,-4,4,0,0
2128787,1,1,3,4,-1,1,0,0
2128787,2,1,6,4,2,0,2,2
2133573,1,1,2,2,0,0,0,0
2133573,2,1,11,6,5,0,5,5
2134108,1,1,4,10,-6,6,0,0
2134108,2,1,8,8,0,0,0,0
2134726,1,1,6,6,0,0,0,0
2134726,2,1,11,13,-2,2,0,0
2138614,1,1,9,11,-2,3,1,1
2138817,1,1,0,0,0,0,0,0
2138817,2,1,0,0,0,0,0,0
2138817,3,1,0,0,0,0,0,0
2138817,4,1,0,0,0,0,0,0
2138817,5,1,2,2,0,0,0,0
2138817,6,1,0,0,0,0,0,0
2139926,1,1,15,9,6,0,6,4
2140600,1,1,5,3,2,0,2,2
2140600,2,1,4,3,1,0,1,1
2141589,1,1,5,5,0,0,0,0
2141589,2,1,0,0,0,0,0,0
2143117,1,1,15,12,3,0,3,2
2143117,2,1,8,7,1,0,1,1
2143117,3,1,8,8,0,0,0,0
2143512,1,1,7,4,3,0,3,1
2143512,2,1,3,2,1,0,1,0
2149334,1,1,2,2,0,0,0,0
2149334,2,1,5,3,2,0,2,2
2149479,1,1,6,6,0,0,0,0
2151428,1,1,4,3,1,0,1,0
2153078,1,1,7,6,1,0,1,1
2153078,2,1,6,5,1,0,1,1
2159781,1,1,3,3,0,0,0,0
2159781,2,1,5,3,2,1,3,3
2160607,1,1,10,10,0,0,0,0
2161303,1,1,7,7,0,0,0,0
2161303,2,1,4,4,0,0,0,0
2161748,1,1,4,8,-4,4,0,0
2161748,2,1,12,8,4,0,4,4
2161939,1,1,3,3,0,0,0,0
2165500,1,1,4,6,-2,2,0,0
2165500,2,1,4,4,0,0,0,0
2166694,1,1,4,4,0,0,0,0
2166694,2,1,0,0,0,0,0,0
2168031,1,1,3,3,0,0,0,0
2168031,2,1,3,3,0,0,0,0
2170291,1,1,0,0,0,0,0,0
2170291,2,1,0,0,0,0,0,0
2173121,2,1,0,0,0,0,0,0
2173121,3,1,0,0,0,0,0,0
2173121,4,1,0,0,0,0,0,0
2177363,1,1,8,7,1,0,1,0
2177363,2,1,0,0,0,0,0,0
2177363,3,1,3,2,1,0,1,1
2177498,1,1,5,3,2,0,2,2
2177498,2,1,3,3,0,1,1,1
2178078,1,1,2,2,0,0,0,0
2178078,2,1,1,2,-1,1,0,0
2178229,1,1,4,4,0,0,0,0
2178229,2,1,0,0,0,0,0,0
2179962,1,1,2,5,-3,3,0,0
2180129,1,1,6,8,-2,3,1,1
2180129,2,1,2,4,-2,2,0,0
2189089,1,1,9,9,0,0,0,0
2189089,2,1,4,5,-1,1,0,0
2189597,1,1,1,4,-3,3,0,0
2189597,2,1,8,2,6,0,6,3
2189597,4,1,8,4,4,0,4,3
2189705,1,1,3,4,-1,3,2,2
2189705,2,1,7,5,2,1,3,3
2198082,1,1,1,2,-1,1,0,0
2198082,2,1,0,0,0,0,0,0
2198082,3,1,0,0,0,0,0,0
2198130,1,1,0,0,0,0,0,0
2198845,1,1,4,6,-2,3,1,1
2198845,2,1,8,5,3,0,3,3
2199388,1,1,3,4,-1,1,0,0
2201184,1,1,7,8,-1,2,1,1
2201184,2,1,7,6,1,0,1,0
2201678,1,1,4,2,2,0,2,2
2201678,2,1,5,5,0,1,1,1
2201810,1,1,10,11,-1,1,0,0
2201810,2,1,6,9,-3,3,0,0
2201852,1,1,10,9,1,0,1,1
2201868,1,1,6,11,-5,5,0,0
2201912,1,1,10,8,2,1,3,2
2201912,2,1,11,13,-2,5,3,3
2201931,1,1,3,3,0,0,0,0
2201957,1,1,4,5,-1,1,0,0
2202072,1,1,11,7,4,0,4,4
2202072,2,1,10,7,3,0,3,3
2202418,1,1,3,6,-3,3,0,0
2202418,2,1,6,6,0,0,0,0
2202497,1,1,13,8,5,2,7,7
2202611,1,1,8,7,1,0,1,1
2202611,2,1,10,9,1,0,1,1
2202875,1,1,11,12,-1,1,0,0
2203197,1,1,13,10,3,0,3,3
2203197,2,1,0,0,0,0,0,0
2203247,1,1,8,8,0,0,0,0
2203247,2,1,13,12,1,0,1,1
2203381,1,1,12,8,4,0,4,4
2203381,2,1,3,2,1,0,1,0
2203391,1,1,12,9,3,1,4,4
2203501,1,1,4,4,0,0,0,0
2203666,1,1,10,9,1,0,1,1
2203687,1,1,7,4,3,0,3,3
2203687,2,1,8,9,-1,1,0,0
2204109,1,1,6,7,-1,3,2,2
2204109,2,1,5,7,-2,4,2,2
2204161,1,1,4,10,-6,6,0,0
2204161,2,1,0,0,0,0,0,0
2204161,3,1,8,8,0,1,1,0
2204161,4,1,4,4,0,0,0,0
2204184,1,1,8,13,-5,7,2,2
2204184,2,1,11,6,5,0,5,4
2204247,1,1,5,4,1,0,1,1
2204247,2,1,13,9,4,1,5,5
2204408,1,1,0,0,0,0,0,0
2204408,2,1,0,0,0,0,0,0
2205630,1,1,26,19,7,2,9,8
2205630,2,1,6,6,0,0,0,0
2205630,3,1,14,12,2,1,3,3
2205630,4,1,18,12,6,1,7,6
2210532,1,1,4,2,2,0,2,2
2210532,2,1,8,7,1,0,1,1
2210532,3,1,5,4,1,0,1,1
2210532,4,1,9,3,6,0,6,5
2213603,1,1,8,4,4,0,4,4
2218838,1,1,6,5,1,0,1,1
2218838,2,1,8,5,3,0,3,1
2220815,1,1,14,7,7,0,7,5
2220815,2,1,13,7,6,0,6,5
2225713,1,1,3,6,-3,3,0,0
2225713,2,1,4,4,0,1,1,1
2226342,1,1,11,9,2,2,4,3
2226342,2,1,2,12,-10,10,0,0
2226384,1,1,6,4,2,0,2,0
2226384,2,1,5,5,0,0,0,0
2226734,1,1,6,7,-1,2,1,1
2226734,2,1,9,8,1,0,1,0
2226734,3,1,8,6,2,0,2,2
2226928,1,1,27,15,12,3,15,2
2226928,2,1,0,0,0,0,0,0
2227129,1,1,7,6,1,0,1,1
2227309,1,1,5,4,1,0,1,0
2227309,2,1,1,1,0,0,0,0
2227325,1,1,7,7,0,0,0,0
2227325,2,1,6,5,1,0,1,1
2227325,3,1,3,3,0,0,0,0
2227325,4,1,19,12,7,2,9,9
2227498,1,1,6,6,0,0,0,0
2227499,1,1,4,4,0,0,0,0
2227913,1,1,9,6,3,0,3,3
2227913,2,1,2,2,0,0,0,0
2227918,1,1,5,6,-1,1,0,0
2227918,2,1,3,2,1,0,1,0
2227954,1,1,2,3,-1,1,0,0
2227954,2,1,6,5,1,0,1,1
2228028,1,1,2,2,0,0,0,0
2228028,2,1,4,4,0,0,0,0
2228569,1,1,0,0,0,0,0,0
2228569,2,1,4,6,-2,4,2,2
2229139,1,1,7,7,0,0,0,0
2229139,2,1,7,7,0,0,0,0
2229194,1,1,3,3,0,0,0,0
2229194,2,1,2,2,0,0,0,0
2229219,1,1,8,5,3,0,3,3
2229219,2,1,6,4,2,0,2,1
2229255,1,1,5,5,0,0,0,0
2229255,2,1,3,3,0,0,0,0
2229464,1,1,7,7,0,0,0,0
2229509,1,1,2,2,0,0,0,0
2230482,1,1,4,2,2,1,3,3
2230482,2,1,10,5,5,0,5,5
2231832,1,1,11,9,2,0,2,1
2231832,2,1,9,6,3,0,3,3
2231974,1,1,4,4,0,0,0,0
2231974,2,1,2,2,0,0,0,0
2231979,1,1,0,0,0,0,0,0
2232247,1,1,5,5,0,0,0,0
2232461,1,1,12,5,7,0,7,7
2232461,2,1,9,7,2,0,2,2
2232461,3,1,12,10,2,0,2,2
2232719,1,1,9,9,0,0,0,0
2232719,2,1,5,5,0,0,0,0
2232765,1,1,5,3,2,0,2,2
2232765,2,1,4,4,0,0,0,0
2232877,1,1,2,2,0,0,0,0
2232877,2,1,2,2,0,0,0,0
2234135,1,1,7,7,0,0,0,0
2239086,1,1,2,5,-3,4,1,1
2239162,1,1,2,2,0,1,1,0
2239184,1,1,8,8,0,2,2,1
2239184,2,1,7,6,1,0,1,1
2239342,1,1,1,4,-3,3,0,0
2239342,2,1,7,6,1,0,1,1
2239385,1,1,5,4,1,0,1,0
2239385,2,1,4,6,-2,2,0,0
2239477,1,1,9,8,1,0,1,1
2239536,1,1,2,5,-3,3,0,0
2239536,2,1,0,0,0,0,0,0
2239728,1,1,9,6,3,0,3,0
2239728,2,1,7,5,2,0,2,0
2239969,1,1,8,8,0,0,0,0
2239969,2,1,7,6,1,0,1,1
2240431,1,1,3,3,0,1,1,0
2240464,1,1,8,5,3,0,3,0
2240464,2,1,5,5,0,1,1,1
2240492,1,1,5,5,0,0,0,0
2240800,1,1,6,6,0,0,0,0
2240800,2,1,8,8,0,2,2,2
2241284,1,1,9,11,-2,2,0,0
2241284,2,1,6,6,0,0,0,0
2241355,1,1,6,6,0,0,0,0
2241355,2,1,11,4,7,0,7,0
2241496,1,1,6,5,1,0,1,0
2241726,1,1,7,5,2,0,2,2
2241936,1,1,6,6,0,3,3,2
2241936,2,1,8,6,2,2,4,3
2241982,1,1,7,4,3,0,3,1
2242206,1,1,3,3,0,0,0,0
2242206,2,1,5,5,0,0,0,0
2242251,1,1,2,2,0,0,0,0
2242251,2,1,2,2,0,0,0,0
2242812,1,1,9,2,7,0,7,7
2242812,2,1,4,4,0,0,0,0
2242838,1,1,0,0,0,0,0,0
2242838,2,1,14,2,12,0,12,0
2242861,1,1,5,4,1,0,1,0
2243183,1,1,6,4,2,1,3,2
2243183,2,1,7,6,1,0,1,1
2243505,1,1,3,3,0,0,0,0
2243505,2,1,8,8,0,0,0,0
2243827,1,1,2,2,0,0,0,0
2243827,2,1,0,0,0,0,0,0
2243972,1,1,8,4,4,0,4,3
2244321,1,1,3,3,0,0,0,0
2244321,2,1,3,2,1,1,2,2
2245486,1,1,5,5,0,0,0,0
2245751,1,1,7,6,1,0,1,0
2246501,1,1,6,6,0,0,0,0
2246501,2,1,7,7,0,0,0,0
2246501,3,1,17,6,11,1,12,12
2247265,1,1,10,8,2,2,4,2
2247265,2,1,4,4,0,0,0,0
2247760,1,1,15,8,7,0,7,6
2248417,1,1,8,8,0,0,0,0
2248417,2,1,1,6,-5,5,0,0
2249463,1,1,6,4,2,0,2,2
2249511,1,1,2,5,-3,3,0,0
2249511,2,1,2,5,-3,3,0,0
2254056,1,1,9,8,1,0,1,1
2254056,2,1,5,2,3,0,3,3
2254256,1,1,7,8,-1,2,1,1
2254256,2,1,2,2,0,0,0,0
2254924,1,1,2,2,0,0,0,0
2254924,2,1,10,3,7,0,7,6
2254943,1,1,9,5,4,1,5,0
2254955,1,1,4,4,0,0,0,0
2254955,2,1,2,8,-6,6,0,0
2255154,1,1,12,3,9,0,9,9
2255154,2,1,6,3,3,0,3,3
2256477,1,1,2,2,0,0,0,0
2256662,1,1,0,0,0,0,0,0
2256662,2,1,0,0,0,0,0,0
2256736,1,1,7,5,2,0,2,1
2256820,1,1,6,4,2,0,2,2
2256820,2,1,5,3,2,0,2,2
2256825,1,1,8,5,3,0,3,2
2256825,2,1,5,3,2,0,2,2
2256904,1,1,0,0,0,0,0,0
2256904,2,1,5,5,0,1,1,1
2256904,3,1,9,4,5,0,5,5
2257216,1,1,20,14,6,0,6,4
2257216,2,1,4,2,2,0,2,2
2257216,3,1,8,10,-2,7,5,5
2257227,1,1,17,8,9,0,9,9
2257227,2,1,3,3,0,1,1,1
2258254,1,1,6,8,-2,3,1,0
2258254,2,1,6,4,2,0,2,2
2258542,1,1,5,3,2,0,2,2
2258542,2,1,7,4,3,0,3,3
2258542,3,1,8,8,0,0,0,0
2258542,4,1,5,5,0,0,0,0
2258654,1,1,6,6,0,2,2,0
2258654,2,1,11,13,-2,5,3,2
2258854,1,1,12,11,1,0,1,0
2258854,2,1,10,6,4,0,4,4
2258866,1,1,5,8,-3,3,0,0
2258866,2,1,19,13,6,0,6,4
2258866,3,1,15,15,0,4,4,4
2259284,1,1,5,5,0,0,0,0
2259284,2,1,13,13,0,0,0,0
2259385,1,1,12,12,0,1,1,1
2259385,2,1,4,5,-1,1,0,0
2259588,1,1,5,5,0,0,0,0
2259665,1,1,4,4,0,0,0,0
2259665,2,1,3,6,-3,3,0,0
2259847,1,1,5,4,1,0,1,0
2259847,2,1,4,4,0,0,0,0
2259847,3,1,5,6,-1,1,0,0
2260006,1,1,4,4,0,0,0,0
2260006,2,1,10,7,3,2,5,5
2260076,1,1,16,15,1,0,1,1
2260089,1,1,11,8,3,0,3,3
2260089,2,1,3,8,-5,6,1,1
2260709,1,1,5,4,1,0,1,1
2260709,2,1,5,6,-1,1,0,0
2261150,1,1,14,5,9,0,9,8
2262076,1,1,6,4,2,0,2,2
2262076,2,1,2,2,0,0,0,0
2262084,1,1,5,4,1,0,1,1
2262084,2,1,0,0,0,0,0,0
2262205,1,1,3,2,1,0,1,1
2262248,1,1,14,7,7,0,7,7
2262435,1,1,2,6,-4,4,0,0
2262971,1,1,3,5,-2,2,0,0
2262971,2,1,12,8,4,0,4,4
2263133,1,1,8,8,0,0,0,0
2263133,2,1,2,2,0,0,0,0
2264181,1,1,21,9,12,0,12,12
2264181,2,1,20,9,11,0,11,9
2270913,1,1,6,6,0,0,0,0
2270913,2,1,7,7,0,0,0,0
2281181,1,1,8,9,-1,2,1,1
2281181,2,1,3,3,0,0,0,0
2281181,4,1,0,0,0,0,0,0
2283119,1,1,4,4,0,0,0,0
2285494,1,1,11,7,4,0,4,4
2285494,2,1,6,4,2,0,2,2
2285494,3,1,3,6,-3,3,0,0
2285494,4,1,6,4,2,0,2,2
2287241,1,1,6,5,1,1,2,2
2287241,2,1,3,3,0,1,1,0
2289321,1,1,3,3,0,0,0,0
2295792,1,1,2,4,-2,2,0,0
2295946,1,1,0,0,0,0,0,0
2480848,1,1,4,4,0,1,1,1
2480848,2,1,13,11,2,1,3,3
2481805,1,1,14,6,8,0,8,8
2481805,2,1,1,3,-2,2,0,0
2482036,1,1,17,8,9,0,9,5
2482036,2,1,0,0,0,0,0,0
2482036,3,1,6,3,3,1,4,0
2482232,1,1,5,4,1,0,1,0
2482232,2,1,4,6,-2,2,0,0
2482232,3,1,7,3,4,0,4,4
2482232,4,1,6,4,2,0,2,2
2482232,5,1,5,5,0,0,0,0
2482355,1,1,4,4,0,1,1,0
2482355,2,1,5,5,0,0,0,0
2482588,1,1,10,9,1,0,1,0
2482588,2,1,6,6,0,0,0,0
2482955,2,1,0,0,0,0,0,0
2482955,3,1,0,0,0,0,0,0
2483036,1,1,0,0,0,0,0,0
2483036,2,1,0,0,0,0,0,0
2483117,1,1,9,8,1,0,1,1
2483117,2,1,4,4,0,0,0,0
2483117,3,1,5,3,2,0,2,2
2483211,1,1,4,4,0,0,0,0
2483211,2,1,2,2,0,0,0,0
2483437,1,1,7,6,1,0,1,0
2483437,2,1,10,5,5,0,5,4
2483437,3,1,9,2,7,0,7,1
2483647,1,1,11,9,2,0,2,1
2483965,1,1,6,3,3,0,3,2
2483965,2,1,1,4,-3,3,0,0
2483965,3,1,3,2,1,0,1,0
2483965,4,1,7,4,3,0,3,0
2484005,1,1,0,0,0,0,0,0
2484282,1,1,2,2,0,0,0,0
2484282,2,1,6,5,1,0,1,1
2484878,1,1,10,8,2,0,2,2
2484878,2,1,4,5,-1,1,0,0
2484936,1,1,0,0,0,0,0,0
2484936,2,1,0,0,0,0,0,0
2485351,1,1,7,7,0,0,0,0
2485351,2,1,5,5,0,0,0,0
2485351,3,1,3,5,-2,2,0,0
2485351,4,1,10,6,4,0,4,0
2485452,1,1,4,4,0,0,0,0
2485452,2,1,13,12,1,0,1,0
2485713,1,1,5,6,-1,1,0,0
2485810,1,1,2,1,1,0,1,1
2485810,2,1,0,0,0,0,0,0
2486483,1,1,7,7,0,0,0,0
2486529,1,1,3,2,1,0,1,1
2486529,2,1,0,0,0,0,0,0
2486529,3,1,6,2,4,0,4,4
2486789,1,1,6,11,-5,5,0,0
2486789,2,1,12,7,5,0,5,3
2486990,1,1,7,5,2,0,2,2
2486990,2,1,5,4,1,0,1,0
2486990,3,1,8,4,4,0,4,0
2487841,1,1,0,0,0,0,0,0
2487841,2,1,2,2,0,0,0,0
2487841,3,1,2,2,0,0,0,0
2488186,1,1,0,0,0,0,0,0
2488186,2,1,2,2,0,0,0,0
2488186,3,1,0,0,0,0,0,0
2489387,1,1,7,8,-1,5,4,3
2489387,2,1,9,11,-2,4,2,2
2489387,4,1,5,3,2,0,2,2
2489387,5,1,2,2,0,0,0,0
2490004,1,1,2,4,-2,2,0,0
2490004,2,1,3,3,0,0,0,0
2490004,3,1,6,3,3,0,3,1
2490249,1,1,4,4,0,0,0,0
2490249,2,1,5,4,1,0,1,1
2490412,1,1,8,8,0,1,1,1
2490412,2,1,2,2,0,0,0,0
2491171,1,1,10,8,2,0,2,0
2491171,2,1,4,2,2,0,2,0
2491171,3,1,14,12,2,1,3,2
2491179,1,1,11,10,1,2,3,3
2491179,2,1,2,4,-2,2,0,0
2492330,1,1,3,2,1,0,1,0
2492330,2,1,3,4,-1,1,0,0
2492330,3,1,5,4,1,0,1,0
2492629,1,1,10,3,7,0,7,0
2492629,2,1,4,4,0,0,0,0
2493000,1,1,4,4,0,1,1,1
2493000,2,1,5,4,1,0,1,1
2493109,1,1,5,5,0,0,0,0
2493109,2,1,2,5,-3,3,0,0
2494033,1,1,2,2,0,0,0,0
2494033,2,1,3,5,-2,2,0,0
2494033,3,1,3,2,1,0,1,0
2494270,1,1,5,8,-3,4,1,1
2494270,2,1,6,5,1,0,1,1
2494273,1,1,21,4,17,2,19,13
2494273,2,1,0,0,0,0,0,0
2494273,3,1,3,3,0,0,0,0
2494273,4,1,5,11,-6,6,0,0
2494308,1,1,9,10,-1,2,1,1
2494520,1,1,0,0,0,0,0,0
2494520,2,1,18,14,4,0,4,2
2494973,1,1,10,7,3,0,3,3
2496409,1,1,0,0,0,0,0,0
2496741,1,1,5,6,-1,1,0,0
2496741,2,1,13,13,0,1,1,1
2496884,1,1,0,0,0,0,0,0
2496884,2,1,7,7,0,0,0,0
2497068,1,1,12,1,11,0,11,5
2497454,1,1,15,12,3,0,3,3
2497454,2,1,15,4,11,0,11,3
2497982,1,1,7,4,3,0,3,3
2497982,2,1,1,6,-5,5,0,0
2498152,1,1,7,4,3,0,3,3
2498898,2,1,0,0,0,0,0,0
2498898,3,1,9,5,4,0,4,4
2499407,1,1,0,0,0,0,0,0
2499407,2,1,0,0,0,0,0,0
2499407,3,1,0,0,0,0,0,0
2499407,4,1,0,0,0,0,0,0
2499407,5,1,0,0,0,0,0,0
2499407,6,1,0,0,0,0,0,0
2499407,7,1,0,0,0,0,0,0
2499407,8,1,0,0,0,0,0,0
2500170,1,1,2,3,-1,1,0,0
2500170,2,1,3,5,-2,2,0,0
2500170,3,1,10,9,1,0,1,1
2500170,4,1,0,0,0,0,0,0
2500429,2,1,8,7,1,0,1,1
2500429,3,1,6,5,1,0,1,1
2500429,4,1,4,4,0,1,1,1
2500521,1,1,10,4,6,0,6,3
2500521,2,1,3,3,0,0,0,0
2500891,1,1,5,6,-1,1,0,0
2500891,2,1,3,3,0,0,0,0
2501084,1,1,4,5,-1,2,1,0
2501084,2,1,8,8,0,1,1,0
2501198,1,1,4,6,-2,3,1,1
2501198,2,1,7,6,1,0,1,0
2501198,3,1,8,4,4,0,4,4
2501227,1,1,13,7,6,0,6,6
2501227,2,1,2,4,-2,2,0,0
2503260,1,1,9,7,2,0,2,2
2503260,2,1,0,0,0,0,0,0
2503307,1,1,4,4,0,2,2,2
2503307,2,1,6,5,1,0,1,0
2504324,1,1,3,2,1,0,1,1
2504324,2,1,0,0,0,0,0,0
2504556,1,1,9,8,1,0,1,1
2504556,2,1,7,5,2,0,2,2
2504989,1,1,10,2,8,0,8,7
2504989,2,1,3,2,1,0,1,1
2505116,1,1,4,4,0,0,0,0
2505116,2,1,0,0,0,0,0,0
2505116,3,1,6,5,1,0,1,0
2505607,1,1,5,4,1,0,1,1
2505607,2,1,10,10,0,0,0,0
2505607,3,1,0,0,0,0,0,0
2505607,4,1,6,4,2,0,2,2
2505817,1,1,1,2,-1,1,0,0
2505817,2,1,0,0,0,0,0,0
2505817,3,1,0,0,0,0,0,0
2506122,1,1,3,3,0,0,0,0
2506122,2,1,8,3,5,0,5,5
2506252,1,1,4,14,-10,11,1,1
2506252,2,1,0,0,0,0,0,0
2506460,1,1,19,16,3,0,3,2
2506460,2,1,0,0,0,0,0,0
2506471,1,1,6,4,2,0,2,2
2506471,2,1,2,2,0,0,0,0
2506471,3,1,3,2,1,0,1,1
2506589,1,1,2,2,0,0,0,0
2506589,2,1,11,4,7,2,9,1
2506589,3,1,14,9,5,1,6,5
2506684,1,1,0,0,0,0,0,0
2506684,2,1,4,2,2,0,2,2
2506684,3,1,7,7,0,1,1,1
2506684,4,1,7,11,-4,5,1,1
2507323,1,1,3,2,1,0,1,1
2507323,2,1,8,4,4,0,4,3
2507650,1,1,7,4,3,0,3,3
2507650,2,1,8,4,4,0,4,1
2507650,3,1,6,4,2,0,2,2
2507693,1,1,0,0,0,0,0,0
2507797,1,1,11,12,-1,6,5,5
2507797,2,1,2,2,0,0,0,0
2507948,1,1,1,5,-4,4,0,0
2507948,2,1,10,5,5,0,5,3
2507948,4,1,9,5,4,0,4,4
2507985,1,1,5,3,2,0,2,1
2507985,2,1,0,0,0,0,0,0
2508072,1,1,12,13,-1,6,5,5
2508072,2,1,0,0,0,0,0,0
2508480,1,1,23,21,2,0,2,2
2508480,2,1,2,5,-3,3,0,0
2508480,3,1,9,5,4,0,4,4
2509020,1,1,3,3,0,0,0,0
2509020,2,1,5,5,0,0,0,0
2509020,3,1,0,0,0,0,0,0
2509143,1,1,0,0,0,0,0,0
2509182,2,1,4,3,1,0,1,1
2509182,3,1,10,9,1,0,1,1
2509399,1,1,0,0,0,0,0,0
2509399,2,1,0,0,0,0,0,0
2509600,1,1,8,7,1,4,5,5
2509600,2,1,0,0,0,0,0,0
2509600,3,1,3,3,0,2,2,1
2510096,1,1,25,2,23,0,23,0
2510096,2,1,12,10,2,0,2,2
2510121,1,1,3,7,-4,4,0,0
2510121,2,1,4,5,-1,2,1,1
2510550,1,1,4,2,2,0,2,2
2510550,2,1,6,2,4,0,4,4
2510930,1,1,7,3,4,0,4,4
2510930,2,1,2,3,-1,1,0,0
2510930,3,1,9,5,4,0,4,4
2512005,1,1,4,3,1,0,1,1
2512005,2,1,5,5,0,0,0,0
2512005,3,1,7,3,4,0,4,4
2512457,1,1,11,7,4,0,4,4
2512532,1,1,3,3,0,0,0,0
2512532,2,1,9,8,1,2,3,2
2513360,1,1,7,5,2,2,4,4
2513360,2,1,8,8,0,2,2,2
2514061,1,1,11,12,-1,5,4,3
2514061,2,1,3,6,-3,3,0,0
2514061,3,1,0,0,0,0,0,0
2514661,1,1,7,7,0,0,0,0
2514661,2,1,7,4,3,0,3,3
2514915,1,1,3,3,0,0,0,0
2514915,2,1,10,8,2,0,2,1
2515105,1,1,6,8,-2,2,0,0
2515105,2,1,5,2,3,0,3,3
2515105,3,1,5,6,-1,1,0,0
2515105,4,1,0,0,0,0,0,0
2515209,1,1,0,0,0,0,0,0
2515209,2,1,4,4,0,0,0,0
2515992,1,1,4,4,0,0,0,0
2515992,2,1,2,2,0,0,0,0
2515992,3,1,10,10,0,0,0,0
2516057,1,1,2,2,0,0,0,0
2516057,3,1,7,8,-1,5,4,4
2517000,1,1,13,13,0,4,4,4
2517379,1,1,9,6,3,0,3,2
2517379,2,1,10,7,3,0,3,0
2519303,1,1,7,5,2,0,2,2
2519303,2,1,8,5,3,0,3,3
2519303,3,1,0,0,0,0,0,0
2519303,4,1,0,0,0,0,0,0
2519306,1,1,4,3,1,0,1,0
2519306,2,1,0,0,0,0,0,0
2519981,1,1,7,5,2,0,2,2
2519981,2,1,0,0,0,0,0,0
2520139,3,1,6,5,1,1,2,1
2520341,1,1,8,9,-1,2,1,0
2520341,2,1,4,4,0,0,1,0
2520733,1,1,5,6,-1,1,0,0
2520733,2,1,9,9,0,0,0,0
2521451,1,1,4,2,2,0,2,2
2521451,2,1,4,4,0,0,0,0
2521495,1,1,5,3,2,1,3,3
2521495,2,1,7,3,4,1,5,5
2521495,3,1,0,0,0,0,0,0
2521495,4,1,3,2,1,0,1,1
2521765,1,1,15,9,6,0,6,4
2521765,2,1,13,11,2,0,2,1
2521827,1,1,8,6,2,0,2,2
2522094,1,1,2,3,-1,1,0,0
2522094,2,1,1,1,0,0,0,0
2522094,3,1,1,1,0,0,0,0
2522938,1,1,12,8,4,1,5,0
2522938,2,1,7,6,1,0,1,0
2523017,1,1,6,6,0,0,0,0
2523017,2,1,3,3,0,0,0,0
2523017,3,1,6,3,3,0,3,3
2523409,1,1,3,6,-3,3,0,0
2523409,2,1,0,0,0,0,0,0
2523439,1,1,7,7,0,0,0,0
2523439,2,1,2,2,0,0,0,0
2524174,1,1,10,9,1,0,1,0
2524174,2,1,2,2,0,0,0,0
2524174,3,1,0,0,0,0,0,0
2524719,1,1,7,5,2,2,4,4
2525092,2,1,3,2,1,0,1,0
2525500,1,1,7,4,3,0,3,3
2525500,2,1,6,3,3,0,3,3
2525581,1,1,10,18,-8,10,2,2
2525581,2,1,7,6,1,3,4,4
2525758,1,1,0,0,0,0,0,0
2525758,2,1,0,0,0,0,0,0
2525758,3,1,0,0,0,0,0,0
2526184,1,1,11,4,7,0,7,0
2526184,2,1,10,10,0,3,3,3
2526572,1,1,11,11,0,0,0,0
2526572,2,1,15,14,1,2,3,3
2526572,3,1,6,6,0,0,0,0
2527241,1,1,9,7,2,0,2,2
2527241,2,1,14,10,4,0,4,3
2527584,1,1,0,0,0,0,0,0
2527584,2,1,7,7,0,0,0,0
2528356,2,1,3,2,1,0,1,1
2528542,2,1,16,8,8,0,8,8
2528542,3,1,11,8,3,1,4,4
2528830,1,1,6,5,1,0,1,1
2528830,2,1,3,8,-5,5,0,0
2529211,1,1,14,11,3,1,4,2
2529211,2,1,3,6,-3,4,1,1
2529211,3,1,5,4,1,2,3,1
2529345,1,1,0,0,0,0,0,0
2529345,2,1,1,4,-3,3,0,0
2529466,1,1,7,7,0,0,0,0
2529466,2,1,5,4,1,0,1,0
2529800,1,1,6,6,0,0,0,0
2529800,2,1,11,10,1,0,1,1
2529928,1,1,2,4,-2,2,0,0
2529928,2,1,1,2,-1,1,0,0
2530266,1,1,8,6,2,0,2,2
2530266,2,1,2,4,-2,2,0,0
2530266,3,1,2,2,0,0,0,0
2530266,4,1,12,9,3,0,3,1
2530424,1,1,0,0,0,0,0,0
2530424,2,1,0,0,0,0,0,0
2530424,3,1,0,0,0,0,0,0
2530706,1,1,5,5,0,0,0,0
2530706,2,1,3,4,-1,1,0,0
2530774,1,1,7,4,3,0,3,2
2530774,2,1,17,14,3,0,3,2
2530807,1,1,3,4,-1,1,0,0
2530807,2,1,2,2,0,0,0,0
2530914,1,1,5,16,-11,12,1,0
2530914,2,1,5,6,-1,2,1,0
2531756,1,1,7,4,3,2,5,3
2531756,2,1,11,4,7,0,7,5
2531890,1,1,16,13,3,1,4,3
2531890,2,1,11,6,5,1,6,6
2531890,3,1,12,6,6,1,7,3
2532201,1,1,13,3,10,0,10,10
2532201,2,1,5,2,3,0,3,2
2532468,1,1,7,4,3,0,3,3
2532468,2,1,3,2,1,0,1,1
2532468,3,1,4,4,0,0,0,0
2533347,1,1,8,4,4,0,4,1
2533573,1,1,4,3,1,0,1,1
2533573,2,1,14,11,3,0,3,2
2533573,3,1,13,12,1,0,1,1
2533573,4,1,11,11,0,1,1,1
2533733,2,1,13,5,8,0,8,8
2533951,1,1,2,2,0,0,0,0
2533951,2,1,0,0,0,0,0,0
2534253,1,1,4,3,1,0,1,1
2534253,2,1,5,5,0,0,0,0
2534253,3,1,0,0,0,0,0,0
2534253,4,1,6,5,1,0,1,1
2534862,1,1,9,12,-3,4,1,1
2534862,2,1,3,3,0,0,0,0
2535362,1,1,2,6,-4,5,1,1
2535362,2,1,10,6,4,0,4,4
2535482,1,1,4,4,0,0,0,0
2535482,2,1,2,2,0,0,0,0
2535482,3,1,0,0,0,0,0,0
2535840,1,1,11,16,-5,5,0,0
2535840,2,1,0,0,0,0,0,0
2536089,1,1,5,5,0,0,0,0
2536089,2,1,2,9,-7,7,0,0
2536089,3,1,10,5,5,0,5,2
2536965,1,1,7,7,0,0,0,0
2536965,2,1,1,2,-1,1,0,0
2537324,1,1,17,12,5,0,5,4
2537324,2,1,13,12,1,0,1,1
2537613,1,1,2,2,0,0,0,0
2537613,2,1,2,2,0,0,0,0
2537754,1,1,11,14,-3,4,1,1
2537754,2,1,0,0,0,0,0,0
2538734,1,1,13,4,9,0,9,2
2538734,2,1,2,4,-2,2,0,0
2538734,3,1,7,5,2,0,2,2
2538928,1,1,3,3,0,0,0,0
2538928,2,1,0,0,0,0,0,0
2538928,3,1,3,6,-3,4,1,1
2539701,1,1,4,4,0,0,0,0
2540216,1,1,6,6,0,0,0,0
2540216,2,1,2,6,-4,4,0,0
2540455,1,1,2,2,0,0,0,0
2540455,2,1,0,0,0,0,0,0
2540455,4,1,0,0,0,0,0,0
2540516,1,1,7,6,1,0,1,1
2540516,2,1,9,8,1,0,1,0
2540516,5,1,0,0,0,0,0,0
2541810,1,1,5,5,0,0,0,0
2541810,2,1,10,11,-1,1,0,0
2541893,1,1,4,4,0,0,0,0
2541893,2,1,7,9,-2,2,0,0
2541893,4,1,0,0,0,0,0,0
2542363,1,1,4,2,2,0,2,2
2542363,2,1,7,4,3,0,3,3
2542952,1,1,0,0,0,0,0,0
2543232,1,1,7,3,4,0,4,3
2543232,2,1,8,8,0,0,0,0
2543351,1,1,6,11,-5,5,0,0
2543351,2,1,5,7,-2,3,1,0
2543686,1,1,2,2,0,0,0,0
2543686,2,1,2,2,0,0,0,0
2543686,3,1,8,5,3,3,6,1
2543761,1,1,2,2,0,0,0,0
2544163,1,1,5,5,0,1,1,1
2544163,2,1,4,4,0,0,0,0
2544267,1,1,10,7,3,0,3,3
2544267,2,1,7,5,2,0,2,2
2544718,1,1,7,8,-1,4,3,2
2544718,2,1,7,9,-2,2,0,0
2545402,1,1,10,9,1,0,1,1
2545402,2,1,8,7,1,0,1,1
2545657,1,1,6,7,-1,1,0,0
2546037,1,1,3,4,-1,2,1,1
2546037,2,1,2,4,-2,2,0,0
2546037,3,1,4,4,0,0,0,0
2546903,1,1,3,3,0,0,0,0
2547158,1,1,0,0,0,0,0,0
2547175,1,1,3,2,1,0,1,1
2547175,2,1,6,3,3,0,3,1
2547198,1,1,5,4,1,0,1,0
2547198,2,1,2,4,-2,3,1,0
2547198,3,1,0,0,0,0,0,0
2547198,4,1,3,3,0,1,1,0
2547341,1,1,8,13,-5,6,1,1
2547341,2,1,10,7,3,1,4,4
2547341,3,1,5,3,2,0,2,1
2547399,1,1,2,2,0,0,0,0
2547399,2,1,19,13,6,2,8,8
2547399,3,1,2,2,0,0,0,0
2548142,1,1,9,8,1,0,1,1
2548142,2,1,4,4,0,0,0,0
2548700,1,1,7,7,0,0,0,0
2548700,2,1,4,3,1,0,1,1
2548700,3,1,5,4,1,0,1,1
2549119,1,1,10,7,3,0,3,2
2549119,2,1,19,16,3,0,3,3
2549493,1,1,1,2,-1,1,0,0
2549493,2,1,3,4,-1,1,0,0
2549665,1,1,6,6,0,0,0,0
2549665,2,1,9,7,2,1,3,3
2549665,3,1,3,2,1,0,1,1
2549824,1,1,5,5,0,0,0,0
2549824,2,1,1,3,-2,2,0,0
2550653,1,1,13,13,0,5,5,5
2550653,2,1,15,17,-2,4,2,2
2550653,3,1,11,5,6,0,6,6
2550653,4,1,0,0,0,0,0,0
2551016,1,1,13,19,-6,7,1,0
2551016,2,1,1,2,-1,1,0,0
2551016,3,1,9,8,1,0,1,0
2551016,4,1,10,5,5,2,7,0
2551589,2,1,0,0,0,0,0,0
2551589,3,1,2,2,0,0,0,0
2552191,1,1,2,1,1,0,1,1
2552191,2,1,2,2,0,0,0,0
2552191,3,1,0,0,0,0,0,0
2552191,4,1,3,2,1,0,1,1
2552298,1,1,2,2,0,0,0,0
2552298,2,1,4,2,2,0,2,2
2552421,1,1,10,9,1,0,1,1
2552421,2,1,1,4,-3,3,0,0
2552907,1,1,7,8,-1,2,1,1
2552907,2,1,4,6,-2,2,0,0
2553322,1,1,16,11,5,0,5,4
2553322,2,1,2,6,-4,5,1,1
2553322,3,1,6,2,4,0,4,0
2554265,1,1,6,5,1,0,1,0
2554566,1,1,5,4,1,0,1,1
2554566,2,1,19,10,9,0,9,9
2554829,1,1,0,0,0,0,0,0
2554980,1,1,4,4,0,0,0,0
2554980,2,1,2,2,0,0,0,0
2555160,1,1,7,6,1,0,1,0
2555160,2,1,0,0,0,0,0,0
2555160,3,1,12,2,10,0,10,0
2555976,1,1,2,2,0,0,0,0
2555976,2,1,6,7,-1,1,0,0
2555976,3,1,0,0,0,0,0,0
2556244,1,1,9,7,2,0,2,2
2556244,2,1,10,6,4,0,4,0
2556356,1,1,8,2,6,0,6,6
2556356,2,1,0,0,0,0,0,0
2556463,1,1,7,5,2,0,2,2
2556463,2,1,6,6,0,2,2,2
2556463,3,1,7,2,5,0,5,5
2556567,1,1,7,7,0,0,0,0
2556567,2,1,6,6,0,0,0,0
2556593,1,1,8,6,2,3,5,3
2556593,2,1,10,9,1,0,1,1
2557353,1,1,3,10,-7,7,0,0
2557353,2,1,4,9,-5,6,1,1
2558011,1,1,8,8,0,0,0,0
2558011,2,1,2,4,-2,2,0,0
2558011,3,1,11,4,7,0,7,0
2558011,4,1,7,2,5,0,5,0
2558156,1,1,4,4,0,0,0,0
2558156,2,1,5,5,0,0,0,0
2558351,1,1,4,4,0,0,0,0
2558351,2,1,10,9,1,1,2,2
2558605,1,1,7,7,0,0,0,0
2558605,2,1,6,6,0,0,0,0
2558605,3,1,10,6,4,2,6,6
2558605,4,1,1,2,-1,1,0,0
2559142,1,1,3,4,-1,2,1,1
2559375,2,1,5,5,0,0,0,0
2559375,3,1,7,7,0,0,0,0
2559609,1,1,3,4,-1,1,0,0
2559609,2,1,5,3,2,1,3,3
2559682,1,1,7,8,-1,1,0,0
2559682,2,1,0,0,0,0,0,0
2559809,1,1,4,2,2,0,2,1
2559809,2,1,8,9,-1,2,1,1
2559809,3,1,2,4,-2,2,0,0
2560802,1,1,6,6,0,0,0,0
2560802,2,1,18,14,4,0,4,2
2561887,1,1,7,4,3,0,3,3
2561887,2,1,9,8,1,2,3,3
2562127,1,1,9,11,-2,2,0,0
2562127,2,1,5,2,3,0,3,3
2562127,3,1,6,4,2,0,2,1
2563198,1,1,2,2,0,0,0,0
2563198,2,1,0,0,0,0,0,0
2564055,1,1,5,4,1,0,1,0
2565278,1,1,9,7,2,0,2,0
2565278,2,1,3,2,1,0,1,0
2565725,1,1,9,9,0,2,2,2
2565725,2,1,15,12,3,0,3,3
2566020,1,1,4,4,0,0,0,0
2566020,2,1,7,8,-1,1,0,0
2566671,1,1,7,9,-2,3,1,1
2566671,2,1,24,10,14,0,14,13
2567851,2,1,0,0,0,0,0,0
2568069,1,1,11,5,6,0,6,6
2568570,1,1,11,11,0,1,1,0
2568570,2,1,6,6,0,0,0,0
2569073,1,1,13,7,6,0,6,6
2569073,2,1,12,9,3,0,3,1
2569183,1,1,4,4,0,0,0,0
2569183,2,1,2,2,0,0,0,0
2569945,1,1,12,4,8,0,8,5
2569945,2,1,2,2,0,0,0,0
2569945,3,1,0,0,0,0,0,0
2569945,4,1,0,0,0,0,0,0
2570142,1,1,8,6,2,0,2,1
2571196,1,1,15,14,1,2,3,3
2571196,2,1,6,7,-1,1,0,0
2571399,1,1,2,2,0,1,1,1
2571399,2,1,8,4,4,0,4,2
2571556,2,1,2,2,0,0,0,0
2571600,1,1,10,2,8,1,9,1
2571600,3,1,0,0,0,0,0,0
2571664,1,1,10,6,4,0,4,3
2571664,2,1,2,2,0,0,0,0
2571732,1,1,3,2,1,0,1,0
2571732,2,1,1,2,-1,1,0,0
2571929,1,1,11,6,5,0,5,2
2572858,1,1,0,0,0,0,0,0
2572868,1,1,10,8,2,0,2,2
2573618,1,1,0,0,0,0,0,0
2573618,2,1,0,0,0,0,0,0
2573760,1,1,9,8,1,0,1,1
2573760,2,1,3,4,-1,1,0,0
2574032,1,1,8,8,0,0,0,0
2574032,2,1,11,6,5,0,5,4
2574141,1,1,5,8,-3,3,0,0
2574141,2,1,4,6,-2,2,0,0
2574433,1,1,5,5,0,0,0,0
2575454,1,1,5,6,-1,4,3,2
2575454,2,1,3,5,-2,2,0,0
2575454,3,1,11,10,1,0,1,0
2575773,1,1,2,2,0,0,0,0
2575773,2,1,2,4,-2,2,0,0
2575773,4,1,5,6,-1,2,1,1
2575823,1,1,2,3,-1,1,0,0
2575823,2,1,6,4,2,0,2,0
2575823,3,1,8,6,2,0,2,1
2575823,4,1,13,2,11,0,11,0
2576001,1,1,17,4,13,1,14,0
2576001,2,1,6,5,1,1,2,2
2576001,3,1,4,2,2,0,2,2
2576343,1,1,4,3,1,0,1,1
2576343,2,1,7,4,3,0,3,3
2576343,4,1,6,5,1,0,1,1
2576492,1,1,4,4,0,0,0,0
2576492,2,1,4,3,1,0,1,1
2576492,3,1,9,5,4,0,4,4
2577141,1,1,5,5,0,0,0,0
2577141,2,1,7,7,0,0,0,0
2577141,3,1,5,6,-1,1,0,0
2577289,1,1,4,9,-5,5,0,0
2577289,2,1,2,7,-5,5,0,0
2577289,3,1,3,3,0,0,0,0
2577289,4,1,12,13,-1,1,0,0
2577665,1,1,1,4,-3,3,0,0
2577665,2,1,6,3,3,1,4,3
2578866,1,1,6,6,0,0,0,0
2578866,2,1,10,8,2,0,2,2
2578866,3,1,10,10,0,2,2,2
2578869,1,1,0,0,0,0,0,0
2578972,1,1,6,6,0,0,0,0
2578972,2,1,3,5,-2,2,0,0
2578972,3,1,2,2,0,0,0,0
2578972,4,1,2,2,0,0,0,0
2579401,1,1,9,4,5,0,5,5
2579401,3,1,2,2,0,0,0,0
2579792,1,1,15,8,7,2,9,4
2579792,2,1,3,2,1,0,1,1
2579792,3,1,2,2,0,0,0,0
2580205,1,1,3,4,-1,2,1,0
2580205,2,1,5,11,-6,6,0,0
2580206,1,1,9,8,1,1,2,2
2580858,1,1,3,4,-1,2,1,1
2580858,2,1,16,13,3,0,3,0
2580858,3,1,0,0,0,0,0,0
2581349,1,1,7,7,0,0,0,0
2581349,2,1,12,13,-1,2,1,1
2581349,3,1,5,4,1,0,1,1
2581366,1,1,11,13,-2,2,0,0
2581441,1,1,2,2,0,0,0,0
2581441,2,1,7,7,0,0,0,0
2581896,1,1,2,4,-2,2,0,0
2581896,2,1,8,7,1,0,1,1
2581896,3,1,6,5,1,0,1,1
2582099,1,1,5,5,0,0,0,0
2582099,2,1,15,13,2,0,2,2
2582199,1,1,4,3,1,0,1,1
2582199,2,1,0,0,0,0,0,0
2583308,1,1,8,6,2,2,4,3
2583308,2,1,3,5,-2,2,0,0
2583494,2,1,6,7,-1,2,1,0
2583494,3,1,0,0,0,0,0,0
2583494,4,1,1,3,-2,2,0,0
2583670,1,1,8,8,0,0,0,0
2583897,1,1,1,6,-5,5,0,0
2584041,1,1,7,7,0,0,0,0
2584041,2,1,9,6,3,0,3,0
2584602,1,1,8,6,2,0,2,2
2584602,2,1,3,3,0,0,0,0
2585036,1,1,2,2,0,0,0,0
2585036,2,1,1,6,-5,5,0,0
2585716,1,1,7,8,-1,1,0,0
2585967,1,1,0,0,0,0,0,0
2585967,2,1,3,3,0,0,0,0
2585967,3,1,5,3,2,0,2,2
2587529,1,1,8,8,0,0,0,0
2587529,2,1,2,4,-2,2,0,0
2588763,1,1,6,5,1,0,1,1
2588763,2,1,8,6,2,0,2,0
2588763,3,1,12,5,7,0,7,0
2588861,1,1,10,10,0,0,0,0
2588861,2,1,7,10,-3,4,1,1
2589731,1,1,10,10,0,0,0,0
2589731,2,1,3,2,1,0,1,1
2589731,3,1,3,3,0,0,0,0
2589873,1,1,3,2,1,0,1,1
2589873,2,1,5,4,1,1,2,2
2591249,1,1,13,6,7,0,7,5
2591249,2,1,8,6,2,4,6,5
2591249,3,1,29,3,26,0,26,21
2591281,1,1,4,6,-2,2,0,0
2591511,1,1,4,4,0,0,0,0
2591511,2,1,3,2,1,1,2,2
2591582,1,1,8,8,0,2,2,0
2591582,2,1,7,7,0,0,0,0
2591582,3,1,9,8,1,0,1,1
2591866,1,1,7,7,0,0,0,0
2591866,2,1,9,10,-1,2,1,1
2592915,3,1,0,0,0,0,0,0
2592915,4,1,0,0,0,0,0,0
2592931,1,1,11,5,6,0,6,6
2592931,2,1,4,4,0,1,1,1
2592968,1,1,11,7,4,0,4,2
2592968,2,1,3,3,0,0,0,0
2592968,3,1,9,9,0,0,0,0
2593211,1,1,9,9,0,0,0,0
2593211,2,1,7,9,-2,3,1,0
2593211,3,1,4,3,1,1,2,0
2593356,1,1,7,9,-2,3,1,1
2593356,2,1,3,6,-3,3,0,0
2594174,1,1,4,3,1,0,1,0
2594174,2,1,9,7,2,0,2,1
2594278,1,1,1,7,-6,6,0,0
2594278,2,1,4,6,-2,2,0,0
2594908,1,1,6,4,2,0,2,1
2594908,3,1,6,10,-4,4,0,0
2595329,1,1,2,2,0,0,0,0
2595329,2,1,2,2,0,0,0,0
2595329,3,1,8,3,5,0,5,5
2596197,1,1,8,6,2,1,3,3
2596197,2,1,5,5,0,0,0,0
2597327,1,1,20,13,7,0,7,4
2597327,2,1,0,0,0,0,0,0
2597369,1,1,4,2,2,0,2,2
2597369,2,1,9,3,6,0,6,3
2598758,1,1,4,5,-1,1,0,0
2598758,2,1,5,3,2,0,2,1
2598758,4,1,5,3,2,0,2,0
2599163,1,1,4,8,-4,5,1,1
2599163,2,1,3,4,-1,2,1,1
2599452,1,1,2,2,0,0,0,0
2599452,2,1,1,5,-4,4,0,0
2599587,1,1,11,11,0,0,0,0
2599587,2,1,3,2,1,0,1,1
2599808,1,1,10,7,3,0,3,0
2599808,2,1,2,4,-2,2,0,0
2599819,2,1,2,2,0,0,0,0
2599977,1,1,5,5,0,1,1,1
2599977,2,1,2,11,-9,9,0,0
2601856,1,1,2,2,0,0,0,0
2601856,2,1,5,4,1,0,1,0
2602122,1,1,8,6,2,0,2,1
2602122,2,1,5,10,-5,5,0,0
2603154,1,1,14,13,1,0,1,1
2603154,2,1,6,7,-1,1,0,0
2603325,1,1,13,10,3,2,5,2
2604174,1,1,10,10,0,1,1,1
2604174,3,1,21,22,-1,4,3,3
2604482,1,1,6,6,0,0,0,0
2604560,1,1,4,6,-2,2,0,0
2604640,1,1,3,3,0,0,0,0
2604640,2,1,5,5,0,0,0,0
2604640,3,1,13,8,5,0,5,1
2606291,1,1,0,0,0,0,0,0
2606291,2,1,6,6,0,1,1,1
2606291,3,1,19,6,13,1,14,14
2606426,1,1,4,5,-1,2,1,1
2606694,1,1,8,6,2,0,2,0
2607696,1,1,9,9,0,0,0,0
2607779,1,1,5,5,0,0,0,0
2607779,2,1,9,4,5,1,6,5
2607989,1,1,17,9,8,0,8,8
2607989,2,1,4,2,2,0,2,2
2608789,1,1,6,6,0,0,0,0
2608789,2,1,6,6,0,0,0,0
2608793,1,1,4,4,0,0,0,0
2608938,1,1,9,8,1,0,1,1
2608938,2,1,7,6,1,0,1,1
2608938,3,1,4,4,0,0,0,0
2609724,1,1,11,10,1,0,1,1
2609724,2,1,1,2,-1,1,0,0
2609724,3,1,4,7,-3,3,0,0
2609981,1,1,7,9,-2,2,0,0
2610173,1,1,7,4,3,1,4,4
2610173,2,1,4,5,-1,2,1,1
2610379,2,1,1,2,-1,1,0,0
2610379,3,1,4,2,2,0,2,1
2612631,1,1,3,2,1,1,2,0
2612631,2,1,4,4,0,0,0,0
2612802,1,1,8,8,0,0,0,0
2612802,2,1,7,5,2,0,2,2
2614050,1,1,3,6,-3,3,0,0
2614050,2,1,9,2,7,0,7,7
2614050,3,1,4,4,0,0,0,0
2614050,4,1,6,4,2,0,2,2
2614657,1,1,6,3,3,1,4,3
2614657,2,1,0,0,0,0,0,0
2614657,3,1,23,2,21,0,21,19
2616190,2,1,9,4,5,2,7,7
2616190,3,1,37,2,35,1,36,36
2616207,1,1,4,4,0,0,0,0
2616207,2,1,0,0,0,0,0,0
2616207,3,1,6,5,1,0,1,1
2616554,1,1,3,6,-3,3,0,0
2616554,5,1,0,0,0,0,0,0
2616554,6,1,0,0,0,0,0,0
2616657,1,1,4,4,0,2,2,2
2616657,2,1,3,5,-2,3,1,0
2616657,3,1,4,2,2,0,2,2
2617413,1,1,3,5,-2,2,0,0
2617413,3,1,6,5,1,0,1,1
2617477,1,1,6,8,-2,2,0,0
2617477,2,1,0,0,0,0,0,0
2617505,1,1,4,4,0,0,0,0
2617505,2,1,2,5,-3,3,0,0
2617607,1,1,5,5,0,0,0,0
2617607,2,1,7,7,0,0,0,0
2617936,1,1,5,5,0,0,0,0
2619872,1,1,5,5,0,0,0,0
2619872,2,1,8,7,1,0,1,0
2619872,3,1,4,4,0,0,0,0
2620139,1,1,3,3,0,0,0,0
2620139,2,1,15,8,7,1,8,8
2620139,3,1,18,3,15,0,15,13
2620351,1,1,12,11,1,0,1,0
2620351,2,1,13,9,4,0,4,2
2620781,1,1,9,10,-1,2,1,1
2620781,2,1,8,7,1,1,2,0
2621378,1,1,3,2,1,0,1,0
2621378,2,1,5,3,2,0,2,2
2621640,1,1,12,9,3,1,4,2
2622558,1,1,10,6,4,0,4,2
2622558,2,1,5,5,0,0,0,0
2622558,3,1,6,4,2,0,2,2
2622558,4,1,0,0,0,0,0,0
2623909,3,1,0,0,0,0,0,0
2624311,1,1,10,8,2,0,2,2
2624311,2,1,14,7,7,0,7,7
2625601,1,1,7,7,0,0,0,0
2625601,2,1,10,7,3,0,3,0
2625922,1,1,9,8,1,0,1,0
2626138,1,1,11,9,2,0,2,2
2626138,2,1,17,8,9,0,9,8
2626506,1,1,5,5,0,0,0,0
2626506,2,1,0,0,0,6,0,0
2626560,1,1,6,5,1,0,1,0
2626560,2,1,6,3,3,0,3,3
2626560,3,1,0,0,0,0,0,0
2626650,1,1,2,2,0,0,0,0
2626650,2,1,0,0,0,0,0,0
2626659,2,1,0,0,0,0,0,0
2626994,1,1,7,9,-2,2,0,0
2626994,2,1,8,5,3,0,3,2
2627174,1,1,10,6,4,2,6,5
2627174,2,1,4,4,0,0,0,0
2627174,3,1,17,6,11,0,11,3
2627367,1,1,0,0,0,0,0,0
2627367,2,1,0,0,0,0,0,0
2628164,1,1,8,7,1,0,1,0
2628164,2,1,2,2,0,0,0,0
2628177,1,1,7,7,0,0,0,0
2628177,2,1,9,8,1,0,1,0
2628313,1,1,10,14,-4,4,0,0
2628313,2,1,3,2,1,0,1,1
2628333,1,1,8,7,1,0,1,1
2628333,2,1,3,4,-1,1,0,0
2629576,1,1,8,5,3,1,4,0
2629576,2,1,18,5,13,0,13,1
2629672,1,1,3,3,0,1,1,1
2629672,3,1,2,2,0,0,0,0
2629672,4,1,4,3,1,0,1,1
2630646,1,1,15,10,5,0,5,1
2630646,2,1,3,2,1,0,1,1
2630888,1,1,7,6,1,0,1,1
2630888,2,1,4,3,1,0,1,1
2630962,1,1,14,14,0,2,2,2
2630962,2,1,5,5,0,0,0,0
2631727,1,1,3,3,0,0,0,0
2634323,1,1,20,17,3,0,3,2
2634323,3,1,0,0,0,0,0,0
2634323,5,1,3,7,-4,5,1,1
2634796,1,1,13,12,1,0,1,1
2634796,2,1,9,9,0,2,2,2
2634924,1,1,12,5,7,1,8,7
2634924,2,1,21,4,17,0,17,5
2634924,3,1,4,2,2,0,2,1
2635832,1,1,12,8,4,0,4,4
2636221,1,1,8,10,-2,3,1,1
2636221,2,1,4,3,1,0,1,1
2636285,1,1,7,5,2,1,3,3
2636285,2,1,2,2,0,0,0,0
2636285,3,1,12,5,7,0,7,5
2636473,1,1,10,8,2,0,2,2
2636473,2,1,6,3,3,0,3,3
2637376,1,1,3,5,-2,3,1,1
2637376,2,1,3,2,1,0,1,1
2637476,1,1,0,0,0,0,0,0
2637476,2,1,11,8,3,1,4,4
2637476,3,1,5,3,2,0,2,2
2637826,1,1,5,4,1,0,1,1
2637826,2,1,2,2,0,0,0,0
2637869,1,1,6,6,0,0,0,0
2637869,2,1,0,0,0,0,0,0
2638057,1,1,4,4,0,0,0,0
2638068,1,1,3,5,-2,2,0,0
2638068,2,1,16,4,12,1,13,11
2638068,3,1,4,3,1,1,2,2
2638068,4,1,0,0,0,0,0,0
2638114,1,1,2,2,0,0,0,0
2638114,2,1,17,9,8,0,8,6
2638520,1,1,7,9,-2,2,0,0
2638520,2,1,1,4,-3,3,0,0
2638520,3,1,6,2,4,0,4,0
2639115,3,1,0,0,0,0,0,0
2639115,4,1,0,0,0,0,0,0
2639647,1,1,10,10,0,1,1,0
2639647,2,1,4,4,0,0,0,0
2639695,1,1,7,4,3,0,3,0
2639695,2,1,0,0,0,0,0,0
2639695,3,1,11,6,5,0,5,4
2640207,1,1,23,8,15,2,17,8
2640207,2,1,12,10,2,1,3,3
2640207,3,1,7,5,2,0,2,2
2640207,4,1,6,2,4,0,4,4
2640207,5,1,11,5,6,0,6,6
2640344,1,1,7,7,0,0,0,0
2640344,2,1,12,6,6,0,6,6
2640823,1,1,4,2,2,0,2,2
2640823,2,1,8,8,0,0,0,0
2640823,3,1,3,4,-1,1,0,0
2640919,1,1,11,6,5,0,5,4
2640919,2,1,4,2,2,0,2,2
2640919,3,1,5,5,0,1,1,1
2640919,4,1,7,2,5,0,5,0
2641546,1,1,6,10,-4,7,3,2
2641546,2,1,6,8,-2,3,1,1
2641546,3,1,6,2,4,1,5,1
2641979,1,1,8,8,0,0,0,0
2641979,2,1,4,4,0,0,0,0
2641979,3,1,0,0,0,0,0,0
2642544,1,1,16,11,5,0,5,5
2642544,2,1,15,13,2,0,2,1
2642737,1,1,4,6,-2,3,1,1
2642737,2,1,0,0,0,0,0,0
2642819,1,1,7,6,1,0,1,0
2642819,2,1,3,3,0,0,0,0
2642819,3,1,0,0,0,0,0,0
2643270,1,1,9,8,1,0,1,0
2643270,2,1,3,3,0,0,0,0
2643270,3,1,3,3,0,0,0,0
2644246,1,1,2,2,0,0,0,0
2644246,2,1,8,7,1,0,1,1
2644691,1,1,12,10,2,0,2,2
2644691,2,1,8,2,6,0,6,6
2645029,1,1,9,5,4,2,6,0
2645029,2,1,5,6,-1,4,3,1
2645300,1,1,8,6,2,0,2,1
2645300,2,1,3,2,1,1,2,1
2645403,1,1,4,3,1,0,1,1
2645463,1,1,7,5,2,0,2,2
2646837,1,1,5,5,0,0,0,0
2646837,2,1,6,6,0,0,0,0
2647193,1,1,6,4,2,0,2,2
2647193,2,1,9,5,4,0,4,0
2647193,3,1,13,3,10,0,10,0
2647193,4,1,5,3,2,0,2,2
2647386,1,1,8,7,1,0,1,1
2647386,2,1,9,12,-3,5,2,1
2648938,1,1,11,11,0,0,0,0
2648938,2,1,4,10,-6,6,0,0
2649044,1,1,1,2,-1,1,0,0
2649381,1,1,2,4,-2,3,1,1
2649381,2,1,3,2,1,0,1,1
2649381,3,1,3,4,-1,1,0,0
2649388,1,1,4,3,1,0,1,1
2649388,2,1,17,6,11,0,11,2
2650435,1,1,8,8,0,0,0,0
2650596,1,1,9,8,1,0,1,0
2650596,2,1,7,10,-3,3,0,0
2650596,3,1,3,6,-3,3,0,0
2650712,1,1,16,11,5,2,7,2
2650969,1,1,4,3,1,0,1,0
2650969,2,1,7,7,0,0,0,0
2650969,3,1,8,8,0,0,0,0
2651292,1,1,10,8,2,1,3,3
2652138,1,1,7,3,4,0,4,4
2652138,2,1,2,2,0,0,0,0
2652194,1,1,3,12,-9,9,0,0
2652194,2,1,0,0,0,0,0,0
2652194,4,1,36,5,31,0,31,22
2653206,1,1,11,10,1,2,3,3
2653206,2,1,13,15,-2,2,0,0
2653415,1,1,9,11,-2,2,0,0
2653415,2,1,7,6,1,0,1,1
2654296,1,1,15,7,8,0,8,0
2654296,2,1,6,8,-2,2,0,0
2654296,3,1,5,4,1,1,2,0
2656544,1,1,3,4,-1,1,0,0
2656544,2,1,3,12,-9,9,0,0
2657051,1,1,14,12,2,0,2,2
2657051,2,1,6,5,1,0,1,1
2657190,1,1,11,11,0,2,2,1
2657300,1,1,4,4,0,0,0,0
2657300,2,1,18,15,3,0,3,1
2657510,1,1,6,5,1,0,1,1
2657510,2,1,2,4,-2,2,0,0
2657523,1,1,2,2,0,0,0,0
2657523,2,1,13,14,-1,5,4,4
2658525,1,1,7,8,-1,1,0,0
2658525,2,1,8,18,-10,10,0,0
2658531,1,1,6,2,4,0,4,3
2658531,2,1,4,3,1,0,1,0
2658531,3,1,2,2,0,0,0,0
2658696,1,1,10,2,8,0,8,8
2659106,1,1,9,10,-1,1,0,0
2659106,2,1,4,4,0,0,0,0
2660174,1,1,8,15,-7,8,1,1
2660700,1,1,4,4,0,0,0,0
2660700,2,1,4,2,2,0,2,1
2660700,3,1,0,0,0,0,0,0
2660700,4,1,4,4,0,0,0,0
2660713,1,1,4,4,0,0,0,0
2660713,2,1,4,3,1,0,1,1
2661567,1,1,4,4,0,0,0,0
2661824,1,1,5,5,0,0,0,0
2661824,2,1,4,5,-1,2,1,1
2662124,1,1,12,11,1,2,3,3
2662124,2,1,7,6,1,0,1,1
2662538,1,1,3,4,-1,1,0,0
2662538,2,1,10,10,0,0,0,0
2662538,3,1,5,5,0,0,0,0
2663173,1,1,4,2,2,0,2,2
2663173,2,1,1,2,-1,1,0,0
2663173,3,1,4,4,0,1,1,1
2663763,1,1,7,5,2,0,2,2
2663763,2,1,4,6,-2,2,0,0
2664190,1,1,5,7,-2,2,0,0
2664190,2,1,20,19,1,2,3,3
2664623,1,1,1,3,-2,2,0,0
2664623,2,1,5,4,1,0,1,0
2666231,1,1,8,7,1,0,1,0
2666231,2,1,6,5,1,0,1,0
2666432,1,1,7,15,-8,8,0,0
2666432,2,1,6,11,-5,7,2,1
2699748,1,1,5,2,3,0,3,2
2708912,1,1,2,2,0,0,0,0
2832202,1,1,7,8,-1,1,0,0
2889705,2,1,3,8,-5,5,0,0
2889705,4,1,2,2,0,0,0,0
2889705,5,1,1,2,-1,1,0,0
2890124,1,1,2,2,0,0,0,0
2890124,2,1,4,4,0,2,2,2
2911686,1,1,8,8,0,0,0,0
2911944,1,1,6,6,0,0,0,0
2911944,2,1,8,4,4,0,4,0
2915244,1,1,8,7,1,0,1,1
2915244,2,1,8,6,2,0,2,2
2951216,1,1,8,4,4,0,4,4
2951216,2,1,8,3,5,0,5,3
2953222,1,1,3,4,-1,2,1,0
2953222,2,1,4,4,0,1,1,1
2954224,1,1,7,7,0,0,0,0
2954224,2,1,5,5,0,0,0,0
2971847,1,1,6,4,2,0,2,2
2971847,2,1,5,5,0,0,0,0
2972359,1,1,14,13,1,0,1,1
2972359,2,1,9,9,0,0,0,0
2984645,1,1,3,5,-2,2,0,0
2984645,2,1,8,7,1,0,1,1
2984731,1,1,6,6,0,0,0,0
2984731,2,1,3,2,1,0,1,1
2984852,1,1,5,4,1,0,1,0
2984852,2,1,5,7,-2,2,0,0
2984860,1,1,7,9,-2,3,1,1
2984911,2,1,0,0,0,0,0,0
2984911,3,1,0,0,0,0,0,0
2984975,1,1,6,6,0,0,0,0
2984975,2,1,1,3,-2,2,0,0
2984979,1,1,3,3,0,1,1,1
2985075,1,1,4,5,-1,2,1,1
2985075,2,1,7,3,4,0,4,4
2985090,1,1,8,10,-2,3,1,1
2985090,2,1,6,2,4,0,4,4
2985161,1,1,8,8,0,0,0,0
2985161,2,1,11,8,3,0,3,1
2985161,3,1,4,4,0,0,0,0
2985213,1,1,4,3,1,0,1,0
2985213,2,1,13,8,5,0,5,5
2985225,1,1,5,4,1,0,1,1
2985258,1,1,2,2,0,0,0,0
2985258,2,1,3,3,0,0,0,0
2985298,1,1,3,2,1,0,1,0
2985327,1,1,12,7,5,2,7,2
2985327,4,1,2,4,-2,3,1,1
2985336,1,1,3,2,1,0,1,1
2985336,2,1,12,8,4,0,4,3
2985336,3,1,0,0,0,0,0,0
2985361,1,1,5,5,0,0,0,0
2985361,2,1,6,5,1,0,1,1
2985507,1,1,4,4,0,0,0,0
2985507,2,1,5,4,1,0,1,1
2985518,1,1,2,5,-3,3,0,0
2985518,2,1,15,14,1,1,2,1
2985585,1,1,3,3,0,0,0,0
2985585,2,1,7,10,-3,3,0,0
2985593,1,1,3,5,-2,2,0,0
2985643,1,1,5,5,0,0,0,0
2985643,2,1,5,7,-2,2,0,0
2985643,3,1,5,5,0,1,1,1
2985773,1,1,7,9,-2,2,0,0
2985773,2,1,2,5,-3,3,0,0
2985773,3,1,15,5,10,0,10,0
2985777,3,1,9,9,0,0,0,0
2985777,4,1,3,11,-8,8,0,0
2985780,1,1,9,8,1,0,1,1
2985780,2,1,4,5,-1,1,0,0
2985802,1,1,7,4,3,0,3,3
2985918,1,1,3,2,1,0,1,0
2985918,2,1,5,5,0,0,0,0
2985918,3,1,5,4,1,0,1,1
2986128,1,1,4,9,-5,5,0,0
2986128,2,1,5,7,-2,2,0,0
2986256,1,1,8,9,-1,1,0,0
2986280,1,1,4,4,0,0,0,0
2986280,2,1,3,5,-2,2,0,0
2986296,1,1,4,4,0,0,0,0
2986296,3,1,0,0,0,0,0,0
2986363,1,1,5,5,0,0,0,0
2986495,1,1,12,12,0,0,0,0
2986495,2,1,3,4,-1,1,0,0
2986536,1,1,2,2,0,0,0,0
2986536,2,1,0,0,0,0,0,0
2986536,3,1,3,2,1,0,1,1
2986613,1,1,2,4,-2,2,0,0
2986613,3,1,2,3,-1,1,0,0
2986613,4,1,0,0,0,0,0,0
2986613,5,1,3,2,1,0,1,1
2986624,1,1,7,6,1,3,4,4
2986624,2,1,4,4,0,0,0,0
2986659,1,1,8,6,2,0,2,2
2986862,1,1,6,4,2,0,2,0
2986862,2,1,1,4,-3,3,0,0
2986862,3,1,1,4,-3,3,0,0
2986946,1,1,9,8,1,2,3,2
2986946,2,1,5,4,1,0,1,0
2986946,3,1,4,2,2,0,2,2
2986961,1,1,2,4,-2,3,1,0
2987031,1,1,7,10,-3,3,0,0
2987031,2,1,3,3,0,0,0,0
2987031,3,1,9,4,5,0,5,0
2987286,1,1,11,9,2,1,3,3
2987286,2,1,3,2,1,0,1,1
2987302,1,1,3,5,-2,2,0,0
2987302,2,1,6,2,4,0,4,4
2987370,1,1,5,5,0,0,0,0
2987375,1,1,13,8,5,0,5,3
2987375,2,1,7,4,3,0,3,1
2987513,1,1,0,0,0,0,0,0
2987513,2,1,2,2,0,0,0,0
2987513,3,1,0,0,0,0,0,0
2987548,1,1,23,5,18,0,18,2
2987548,2,1,4,4,0,1,1,1
2987548,3,1,12,5,7,0,7,1
2987571,1,1,7,7,0,0,0,0
2987571,2,1,6,7,-1,2,1,0
2987699,1,1,0,0,0,0,0,0
2987699,2,1,5,4,1,0,1,0
2987702,1,1,10,8,2,0,2,0
2987702,2,1,12,11,1,0,1,0
2987795,1,1,7,5,2,0,2,2
2987811,1,1,6,4,2,0,2,2
2987903,1,1,2,4,-2,2,0,0
2987903,3,1,4,4,0,1,1,0
2987911,1,1,8,8,0,0,0,0
2987930,1,1,3,3,0,0,0,0
2987985,1,1,6,3,3,0,3,3
2988008,1,1,3,6,-3,4,1,1
2988008,3,1,0,0,0,0,0,0
2988009,1,1,9,7,2,0,2,0
2988009,2,1,2,2,0,0,0,0
2988037,1,1,5,8,-3,4,1,1
2988098,1,1,0,0,0,0,0,0
2988098,2,1,4,4,0,0,0,0
2988171,1,1,8,5,3,0,3,3
2988186,1,1,2,2,0,0,0,0
2988186,2,1,2,3,-1,1,0,0
2988186,3,1,6,7,-1,2,1,1
2988264,1,1,3,3,0,1,1,0
2988297,1,1,0,0,0,0,0,0
2988297,2,1,5,6,-1,3,2,2
2988314,1,1,5,5,0,1,1,1
2988314,2,1,15,5,10,0,10,1
2988347,1,1,12,13,-1,1,0,0
2988347,2,1,2,9,-7,7,0,0
2988347,3,1,7,7,0,1,1,0
2988353,2,1,0,0,0,0,0,0
2988353,5,1,0,0,0,0,0,0
2988394,1,1,1,2,-1,1,0,0
2988394,2,1,3,4,-1,1,0,0
2988489,1,1,5,10,-5,5,0,0
2988489,2,1,8,12,-4,4,0,0
2988549,1,1,13,12,1,0,1,1
2988549,2,1,14,14,0,0,0,0
2988554,1,1,0,0,0,0,0,0
2988554,2,1,7,7,0,0,0,0
2988565,1,1,9,9,0,0,0,0
2988565,2,1,9,11,-2,2,0,0
2988651,1,1,15,12,3,0,3,3
2988651,2,1,3,2,1,0,1,1
2988666,1,1,14,12,2,0,2,1
2988666,3,1,7,4,3,0,3,0
2988740,1,1,2,8,-6,6,0,0
2988895,1,1,5,5,0,0,0,0
2988895,2,1,2,2,0,0,0,0
2988978,1,1,0,0,0,0,0,0
2989048,1,1,4,3,1,0,1,1
2989048,2,1,0,0,0,0,0,0
2989048,3,1,0,0,0,0,0,0
2989048,4,1,0,0,0,0,0,0
2989213,1,1,9,8,1,0,1,1
2989213,2,1,3,2,1,0,1,1
2989285,1,1,6,6,0,0,0,0
2989285,2,1,12,11,1,0,1,1
2989290,1,1,0,0,0,0,0,0
2989290,2,1,1,2,-1,1,0,0
2989382,1,1,4,4,0,0,0,0
2989553,1,1,5,5,0,0,0,0
2989553,2,1,5,5,0,0,0,0
2989564,1,1,5,5,0,0,0,0
2989564,2,1,2,3,-1,1,0,0
2989679,1,1,5,1,4,0,4,0
2989679,2,1,3,3,0,0,0,0
2989723,1,1,7,6,1,0,1,1
2989723,2,1,4,7,-3,3,0,0
2989831,1,1,0,0,0,0,0,0
2989831,2,1,0,0,0,0,0,0
2989897,1,1,0,0,0,0,0,0
2990004,1,1,11,10,1,0,1,0
2990004,2,1,7,6,1,0,1,0
2990004,3,1,0,0,0,0,0,0
2990171,1,1,2,2,0,0,0,0
2990171,2,1,10,12,-2,5,3,2
2990314,1,1,0,0,0,0,0,0
2990369,1,1,2,2,0,0,0,0
2990369,2,1,2,4,-2,2,0,0
2990457,1,1,3,11,-8,8,0,0
2990457,3,1,11,3,8,1,9,8
2990467,1,1,5,4,1,1,2,2
2990467,2,1,7,4,3,0,3,3
2990644,1,1,2,2,0,0,0,0
2990644,2,1,2,2,0,0,0,0
2990840,1,1,8,7,1,0,1,1
2990869,1,1,7,7,0,0,0,0
2990869,2,1,2,2,0,0,0,0
2991003,1,1,7,6,1,1,2,2
2991013,1,1,5,5,0,0,0,0
2991059,1,1,15,5,10,0,10,0
2991283,1,1,7,8,-1,2,1,1
2991364,1,1,0,0,0,0,0,0
2991364,2,1,5,4,1,0,1,1
2991364,3,1,3,2,1,0,1,1
2991364,6,1,7,8,-1,3,2,1
2991427,1,1,5,2,3,0,3,3
2991427,2,1,1,2,-1,1,0,0
2991455,1,1,0,0,0,0,0,0
2991455,2,1,0,0,0,0,0,0
2991681,1,1,2,2,0,0,0,0
2991817,1,1,1,2,-1,1,0,0
2991817,2,1,0,0,0,0,0,0
2991855,1,1,12,7,5,0,5,5
2991855,2,1,7,6,1,0,1,1
2991861,1,1,4,7,-3,3,0,0
2991915,1,1,10,8,2,0,2,2
2991958,1,1,0,0,0,0,0,0
2991958,2,1,0,0,0,0,0,0
2991959,1,1,13,9,4,1,5,4
2991998,1,1,0,0,0,0,0,0
2992059,1,1,1,3,-2,2,0,0
2992059,2,1,8,4,4,0,4,3
2992269,1,1,13,15,-2,2,0,0
2992269,2,1,7,8,-1,3,2,2
2992269,4,1,2,4,-2,2,0,0
2992269,5,1,5,5,0,0,0,0
2992274,1,1,0,0,0,0,0,0
2992483,1,1,4,2,2,0,2,1
2992483,2,1,3,2,1,0,1,0
2992483,3,1,5,2,3,0,3,3
2992781,1,1,4,4,0,0,0,0
2992781,2,1,2,2,0,0,0,0
2992852,1,1,6,5,1,0,1,1
2992852,2,1,5,5,0,0,0,0
2992852,3,1,2,2,0,0,0,0
2992864,1,1,4,2,2,0,2,2
2992864,2,1,4,2,2,0,2,2
2992864,3,1,6,4,2,0,2,2
2992944,1,1,8,8,0,1,1,1
2992944,2,1,0,0,0,0,0,0
2992944,3,1,1,3,-2,2,0,0
2993048,1,1,6,4,2,0,2,2
2993048,2,1,18,12,6,2,8,8
2993048,3,1,7,4,3,3,6,2
2993096,1,1,2,2,0,0,0,0
2993096,2,1,2,4,-2,2,0,0
2993126,1,1,2,2,0,0,0,0
2993126,2,1,5,5,0,0,0,0
2993143,1,1,0,0,0,0,0,0
2993224,1,1,2,5,-3,3,0,0
2993304,1,1,0,0,0,0,0,0
2993304,2,1,4,6,-2,2,0,0
2993480,1,1,9,10,-1,2,1,0
2993480,2,1,4,2,2,1,3,0
2993528,1,1,6,7,-1,2,1,1
2993528,2,1,12,12,0,0,0,0
2993528,3,1,5,5,0,0,0,0
2993528,4,1,6,7,-1,1,0,0
2993528,5,1,3,5,-2,2,0,0
2993556,1,1,0,0,0,0,0,0
2993597,1,1,11,12,-1,1,0,0
2993597,2,1,11,10,1,0,1,0
2993718,1,1,0,0,0,0,0,0
2993718,2,1,0,0,0,0,0,0
2993718,3,1,0,0,0,0,0,0
2993856,1,1,5,5,0,0,0,0
2993856,2,1,9,8,1,0,1,1
2993856,3,1,0,0,0,0,0,0
2993918,1,1,1,2,-1,1,0,0
2993918,2,1,0,0,0,0,0,0
2993918,3,1,11,10,1,0,1,1
2993998,1,1,0,0,0,0,0,0
2993998,2,1,0,0,0,0,0,0
2993998,3,1,0,0,0,0,0,0
2993998,4,1,0,0,0,0,0,0
2993998,5,1,0,0,0,0,0,0
2993998,6,1,0,0,0,0,0,0
2994371,1,1,3,8,-5,5,0,0
2994371,2,1,5,2,3,0,3,3
2994381,1,1,3,2,1,0,1,1
2994381,2,1,5,2,3,0,3,3
2994385,1,1,2,4,-2,3,1,1
2994385,2,1,2,2,0,0,0,0
2994399,1,1,4,3,1,0,1,1
2994399,2,1,0,0,0,0,0,0
2994447,1,1,10,10,0,0,0,0
2994447,2,1,5,5,0,0,0,0
2994463,1,1,4,5,-1,1,0,0
2994463,2,1,5,2,3,0,3,3
2994463,3,1,5,5,0,4,4,0
2994482,1,1,6,7,-1,2,1,1
2994572,1,1,14,10,4,0,4,4
2994803,2,1,6,6,0,0,0,0
2994822,1,1,2,5,-3,3,0,0
2994822,2,1,7,5,2,0,2,2
2994895,1,1,6,5,1,0,1,0
2994895,2,1,1,4,-3,3,0,0
2994942,1,1,7,2,5,0,5,4
2994942,3,1,2,3,-1,2,1,1
2994972,1,1,5,13,-8,8,0,0
2994972,2,1,6,6,0,0,0,0
2995019,1,1,2,4,-2,2,0,0
2995019,2,1,0,0,0,0,0,0
2995050,1,1,6,8,-2,2,0,0
2995050,2,1,5,6,-1,1,0,0
2995050,3,1,9,8,1,0,1,0
2995058,1,1,5,7,-2,3,1,1
2995058,2,1,3,6,-3,4,1,1
2995094,1,1,4,2,2,0,2,2
2995094,2,1,7,4,3,2,5,5
2995094,3,1,5,4,1,1,2,2
2995107,1,1,3,2,1,0,1,1
2995137,2,1,9,4,5,0,5,4
2995184,1,1,1,2,-1,1,0,0
2995390,1,1,0,0,0,0,0,0
2995404,1,1,0,0,0,0,0,0
2995404,2,1,7,2,5,0,5,5
2995404,3,1,1,1,0,0,0,0
2995438,1,1,10,8,2,0,2,2
2995438,2,1,5,3,2,0,2,2
2995451,1,1,9,9,0,0,0,0
2995451,2,1,0,0,0,0,0,0
2995479,1,1,5,8,-3,4,1,1
2995479,2,1,5,5,0,0,0,0
2995479,3,1,9,6,3,0,3,3
2995508,1,1,4,4,0,0,0,0
2995508,3,1,3,7,-4,4,0,0
2995508,5,1,8,4,4,0,4,4
2995514,1,1,4,4,0,0,0,0
2995514,2,1,4,4,0,0,0,0
2995544,1,1,0,0,0,0,0,0
2995544,2,1,0,0,0,0,0,0
2995584,1,1,1,2,-1,1,0,0
2995584,2,1,14,4,10,0,10,9
2995681,1,1,5,5,0,0,0,0
2995681,2,1,2,2,0,0,0,0
2995681,3,1,3,2,1,0,1,1
2995744,1,1,4,3,1,0,1,1
2995744,2,1,7,3,4,0,4,4
2995744,3,1,0,0,0,0,0,0
2995757,1,1,0,0,0,0,0,0
2995757,2,1,0,0,0,0,0,0
2995761,1,1,3,2,1,0,1,1
2995761,2,1,3,2,1,0,1,1
2995761,3,1,0,0,0,0,0,0
2995771,1,1,8,8,0,0,0,0
2995771,2,1,1,12,-11,11,0,0
2995771,3,1,5,4,1,0,1,1
2995771,5,1,16,2,14,0,14,13
2995771,6,1,3,2,1,1,2,2
2995835,1,1,1,9,-8,8,0,0
2995835,2,1,2,6,-4,5,1,1
2995843,1,1,0,0,0,0,0,0
2995843,2,1,4,3,1,0,1,1
2995843,3,1,0,0,0,0,0,0
2995843,4,1,3,2,1,0,1,0
2995859,1,1,4,10,-6,7,1,1
2995859,2,1,3,2,1,0,1,0
2995859,3,1,6,6,0,0,0,0
2996009,1,1,2,2,0,0,0,0
2996009,2,1,6,6,0,0,0,0
2996061,1,1,3,3,0,0,0,0
2996185,1,1,2,5,-3,3,0,0
2996185,2,1,7,9,-2,2,0,0
2996193,1,1,2,4,-2,2,0,0
2996193,2,1,8,8,0,0,0,0
2996336,1,1,26,10,16,0,16,2
2996336,2,1,14,12,2,0,2,2
2996572,1,1,9,9,0,1,1,0
2996572,2,1,0,0,0,0,0,0
2996572,3,1,0,0,0,0,0,0
2996964,1,1,0,0,0,0,0,0
2997146,1,1,15,14,1,0,1,1
2997146,2,1,7,8,-1,2,1,1
2997147,1,1,2,2,0,0,0,0
2997369,1,1,9,8,1,0,1,1
2997369,2,1,6,6,0,0,0,0
2997515,2,1,4,3,1,0,1,1
2997736,1,1,18,12,6,1,7,6
2997736,2,1,20,13,7,0,7,4
2997736,3,1,21,18,3,0,3,1
2997804,1,1,19,14,5,0,5,3
2997804,2,1,2,1,1,0,1,1
2997876,1,1,6,6,0,0,0,0
2998011,1,1,2,3,-1,1,0,0
2998011,2,1,0,0,0,0,0,0
2998015,1,1,3,4,-1,1,0,0
2998015,2,1,5,7,-2,3,1,1
2998054,1,1,6,4,2,0,2,1
2998054,2,1,2,2,0,0,0,0
2998139,1,1,4,2,2,0,2,2
2998139,3,1,0,0,0,0,0,0
2998240,1,1,7,6,1,0,1,0
2998371,1,1,7,6,1,0,1,1
2998371,2,1,5,4,1,1,2,2
2998521,1,1,5,7,-2,2,0,0
2998521,2,1,7,6,1,0,1,1
2998641,3,1,2,2,0,0,0,0
2998652,1,1,4,2,2,0,2,2
2998652,2,1,4,2,2,1,3,3
2998652,3,1,1,2,-1,1,0,0
2998652,4,1,4,4,0,0,0,0
2998664,1,1,5,6,-1,1,0,0
2998664,2,1,0,0,0,0,0,0
2998762,1,1,3,4,-1,1,0,0
2998868,1,1,6,6,0,4,4,4
2998868,2,1,6,6,0,0,0,0
2998880,1,1,14,10,4,0,4,4
2998880,4,1,5,4,1,0,1,0
2998946,1,1,3,7,-4,4,0,0
2998946,2,1,3,3,0,0,0,0
2998972,1,1,13,9,4,0,4,4
2998981,1,1,12,11,1,0,1,1
2998981,3,1,5,6,-1,1,0,0
2999037,1,1,10,10,0,0,0,0
2999037,2,1,5,4,1,0,1,0
2999037,3,1,5,5,0,0,0,0
2999144,1,1,1,4,-3,3,0,0
2999184,1,1,8,7,1,0,1,1
2999184,2,1,6,8,-2,2,0,0
2999195,1,1,22,15,7,0,7,6
2999232,1,1,2,2,0,0,0,0
2999232,2,1,5,4,1,0,1,1
2999232,3,1,5,6,-1,1,0,0
2999232,4,1,4,5,-1,1,0,0
2999259,1,1,6,6,0,0,0,0
2999259,2,1,6,4,2,0,2,2
2999270,1,1,8,6,2,0,2,2
2999270,2,1,12,11,1,0,1,1
2999270,3,1,17,12,5,0,5,4
2999270,4,1,17,7,10,0,10,7
2999270,5,1,0,0,0,0,0,0
2999270,6,1,0,0,0,0,0,0
2999409,1,1,2,2,0,0,0,0
2999409,2,1,1,6,-5,5,0,0
2999452,1,1,4,10,-6,8,2,0
2999452,2,1,0,0,0,0,0,0
2999502,1,1,8,7,1,1,2,2
2999502,2,1,6,3,3,0,3,3
2999549,1,1,6,5,1,3,4,4
2999587,1,1,7,7,0,0,0,0
2999734,1,1,8,2,6,0,6,5
2999734,2,1,5,5,0,1,1,1
2999752,1,1,2,2,0,0,0,0
2999752,2,1,9,9,0,0,0,0
3000261,1,1,0,0,0,0,0,0
3000261,2,1,7,2,5,1,6,6
3000261,3,1,7,9,-2,3,1,1
3000307,1,1,5,6,-1,2,1,1
3000307,3,1,0,0,0,0,0,0
3000307,4,1,1,2,-1,1,0,0
3000454,1,1,0,0,0,0,0,0
3000454,3,1,4,2,2,0,2,2
3000555,1,1,7,11,-4,4,0,0
3000555,3,1,5,4,1,0,1,0
3000555,4,1,5,5,0,0,0,0
3000560,1,1,1,4,-3,3,0,0
3000579,1,1,16,17,-1,1,0,0
3000579,2,1,6,10,-4,4,0,0
3000718,1,1,7,6,1,0,1,0
3000735,1,1,8,7,1,0,1,1
3000735,2,1,0,0,0,0,0,0
3000735,3,1,0,0,0,0,0,0
3000786,1,1,3,7,-4,4,0,0
3000786,2,1,5,8,-3,4,1,1
3000867,1,1,17,4,13,0,13,13
3000883,1,1,4,4,0,0,0,0
3000883,2,1,8,8,0,0,0,0
3000906,1,1,12,2,10,0,10,0
3000906,2,1,4,4,0,0,0,0
3000906,3,1,4,4,0,0,0,0
3001204,1,1,10,4,6,0,6,6
3001204,2,1,9,2,7,0,7,6
3001204,3,1,9,2,7,0,7,7
3001204,4,1,5,2,3,0,3,3
3001246,1,1,2,2,0,0,0,0
3001443,1,1,7,7,0,0,0,0
3001443,2,1,4,4,0,0,0,0
3001463,1,1,9,8,1,0,1,1
3001463,2,1,0,0,0,0,0,0
3001544,1,1,5,4,1,0,1,1
3001544,2,1,11,7,4,2,6,3
3001643,1,1,19,12,7,0,7,7
3001643,2,1,22,16,6,0,6,6
3001675,1,1,1,4,-3,3,0,0
3001675,2,1,6,6,0,0,0,0
3001700,1,1,3,4,-1,2,1,1
3001700,2,1,5,2,3,1,4,4
3001700,3,1,11,4,7,0,7,6
3001959,1,1,3,2,1,0,1,1
3001970,1,1,10,6,4,1,5,5
3001970,2,1,15,5,10,0,10,8
3001970,3,1,16,4,12,0,12,6
3002052,1,1,3,4,-1,1,0,0
3002052,2,1,2,2,0,0,0,0
3002168,1,1,12,13,-1,2,1,1
3002168,2,1,5,5,0,1,1,0
3002168,3,1,1,4,-3,3,0,0
3002206,1,1,6,7,-1,1,0,0
3002206,2,1,7,7,0,0,0,0
3002208,1,1,6,6,0,0,0,0
3002208,2,1,4,7,-3,3,0,0
3002279,1,1,2,2,0,0,0,0
3002279,2,1,2,2,0,0,0,0
3002324,1,1,4,1,3,0,3,3
3002324,2,1,16,11,5,0,5,4
3002324,3,1,0,0,0,0,0,0
3002324,4,1,3,2,1,0,1,1
3002324,5,1,4,3,1,0,1,0
3002354,1,1,5,5,0,0,0,0
3002354,2,1,7,7,0,0,0,0
3002354,3,1,6,3,3,0,3,1
3002392,1,1,11,8,3,0,3,3
3002392,2,1,8,5,3,0,3,1
3002524,1,1,5,2,3,0,3,3
3002563,1,1,4,6,-2,2,0,0
3002563,2,1,1,6,-5,5,0,0
3002568,1,1,3,7,-4,4,0,0
3002568,2,1,7,7,0,0,0,0
3002606,1,1,10,7,3,2,5,5
3002606,2,1,3,3,0,0,0,0
3002606,3,1,0,0,0,0,0,0
3002882,1,1,4,4,0,0,0,0
3002882,2,1,4,3,1,0,1,1
3003023,1,1,0,0,0,0,0,0
3003023,2,1,9,9,0,1,1,1
3003184,1,1,6,6,0,0,0,0
3003184,2,1,2,2,0,0,0,0
3003253,1,1,8,8,0,0,0,0
3003253,2,1,7,7,0,0,0,0
3003298,1,1,7,8,-1,3,2,1
3003298,2,1,13,4,9,0,9,0
3003540,1,1,20,18,2,0,2,0
3003600,1,1,9,8,1,0,1,1
3003788,1,1,7,4,3,0,3,2
3003788,2,1,3,2,1,0,1,0
3003788,3,1,5,2,3,0,3,2
3004056,2,1,6,2,4,0,4,3
3004056,3,1,6,2,4,0,4,3
3004191,2,1,4,4,0,1,1,1
3004237,1,1,25,8,17,0,17,17
3004237,2,1,7,7,0,0,0,0
3004485,1,1,1,0,1,0,1,1
3004485,2,1,0,0,0,0,0,0
3004527,1,1,7,4,3,0,3,3
3004527,2,1,12,10,2,0,2,2
3004661,1,1,4,4,0,0,0,0
3004661,2,1,5,5,0,0,0,0
3004828,1,1,0,0,0,0,0,0
3004828,2,1,0,0,0,0,0,0
3004835,1,1,9,9,0,0,0,0
3004847,1,1,6,7,-1,1,0,0
3004847,2,1,7,4,3,0,3,0
3004858,1,1,0,0,0,0,0,0
3004858,2,1,0,0,0,0,0,0
3004941,1,1,8,6,2,0,2,1
3004941,2,1,10,11,-1,2,1,0
3004980,1,1,11,4,7,0,7,5
3004980,2,1,8,4,4,2,6,3
3004980,3,1,0,0,0,0,0,0
3005089,1,1,3,3,0,0,0,0
3005089,2,1,3,4,-1,1,0,0
3005113,1,1,9,9,0,0,0,0
3005134,1,1,5,6,-1,2,1,1
3005134,2,1,3,5,-2,2,0,0
3005212,1,1,7,6,1,1,2,1
3005212,2,1,2,2,0,0,0,0
3005251,1,1,24,16,8,2,10,8
3005376,1,1,2,2,0,0,0,0
3005376,2,1,11,3,8,0,8,7
3005376,3,1,2,2,0,0,0,0
3005389,1,1,5,2,3,0,3,3
3005389,2,1,5,5,0,4,4,4
3005391,1,1,10,8,2,0,2,0
3005391,2,1,3,8,-5,5,0,0
3005391,3,1,5,2,3,0,3,0
3005680,1,1,11,10,1,0,1,1
3005680,2,1,4,3,1,0,1,1
3005753,1,1,5,5,0,2,2,2
3005798,1,1,5,7,-2,2,0,0
3005798,2,1,5,5,0,0,0,0
3005873,1,1,7,6,1,0,1,1
3006012,1,1,3,3,0,0,0,0
3006012,2,1,0,0,0,0,0,0
3006059,1,1,10,9,1,1,2,2
3006059,2,1,0,0,0,0,0,0
3006128,1,1,5,2,3,0,3,0
3006128,3,1,0,0,0,0,0,0
3006162,1,1,0,0,0,0,0,0
3006162,2,1,1,1,0,0,0,0
3006162,3,1,2,2,0,0,0,0
3006171,1,1,0,0,0,0,0,0
3006181,1,1,8,9,-1,2,1,1
3006181,2,1,0,0,0,0,0,0
3006259,1,1,8,4,4,0,4,4
3006308,1,1,2,4,-2,2,0,0
3006308,2,1,4,6,-2,2,0,0
3006352,1,1,8,10,-2,2,0,0
3006352,2,1,10,14,-4,4,0,0
3006354,1,1,6,8,-2,2,0,0
3006354,2,1,5,5,0,0,0,0
3006397,1,1,7,3,4,0,4,1
3006423,1,1,10,10,0,1,1,1
3006423,2,1,3,7,-4,5,1,0
3006435,1,1,10,14,-4,4,0,0
3006435,2,1,4,8,-4,4,0,0
3006470,1,1,0,0,0,0,0,0
3006470,2,1,0,0,0,0,0,0
3006489,1,1,3,3,0,0,0,0
3006489,2,1,2,2,0,1,1,1
3006531,1,1,12,8,4,0,4,4
3006554,1,1,3,2,1,0,1,0
3006554,2,1,7,4,3,0,3,1
3006576,1,1,4,8,-4,4,0,0
3006576,2,1,8,10,-2,2,0,0
3006638,1,1,11,10,1,0,1,1
3006638,2,1,5,11,-6,6,0,0
3006647,1,1,5,5,0,0,0,0
3006647,2,1,5,3,2,0,2,0
3006670,1,1,6,2,4,0,4,3
3006670,2,1,4,4,0,0,0,0
3006785,1,1,7,9,-2,3,1,1
3006785,2,1,4,8,-4,5,1,1
3006824,1,1,3,7,-4,4,0,0
3006824,2,1,2,5,-3,3,0,0
3006859,1,1,2,2,0,0,0,0
3006859,2,1,0,0,0,0,0,0
3006919,1,1,15,14,1,0,1,1
3006919,2,1,7,11,-4,6,2,2
3006943,2,1,2,2,0,0,0,0
3007033,1,1,5,5,0,0,0,0
3007033,2,1,0,0,0,0,0,0
3007061,1,1,5,7,-2,2,0,0
3007138,1,1,3,6,-3,3,0,0
3007146,1,1,5,4,1,0,1,0
3007146,2,1,1,2,-1,1,0,0
3007146,3,1,7,7,0,0,0,0
3007197,1,1,8,9,-1,1,0,0
3007197,2,1,28,20,8,0,8,8
3007197,3,1,7,4,3,0,3,3
3007241,1,1,0,0,0,0,0,0
3007285,1,1,1,1,0,0,0,0
3007304,1,1,0,0,0,0,0,0
3007304,2,1,0,0,0,0,0,0
3007326,1,1,6,2,4,0,4,4
3007326,2,1,6,6,0,0,0,0
3007434,1,1,7,3,4,0,4,4
3007434,2,1,5,5,0,0,0,0
3007437,1,1,7,5,2,0,2,0
3007437,2,1,7,5,2,0,2,2
3007510,1,1,3,3,0,0,0,0
3007510,2,1,8,8,0,1,1,1
3007512,1,1,1,2,-1,1,0,0
3007512,2,1,11,9,2,1,3,3
3007547,1,1,2,3,-1,2,1,1
3007547,2,1,14,15,-1,2,1,1
3007625,1,1,7,6,1,0,1,0
3007676,1,1,5,5,0,0,0,0
3007878,1,1,8,6,2,0,2,2
3007878,2,1,8,6,2,0,2,2
3007878,3,1,4,4,0,0,0,0
3007888,1,1,2,2,0,0,0,0
3007939,1,1,5,9,-4,6,2,2
3007939,3,1,21,3,18,0,18,14
3007939,4,1,18,3,15,0,15,15
3008087,1,1,15,15,0,1,1,1
3008087,2,1,0,0,0,0,0,0
3008092,1,1,10,10,0,0,0,0
3008092,2,1,2,4,-2,2,0,0
3008093,1,1,7,5,2,0,2,2
3008116,1,1,9,11,-2,2,0,0
3008116,2,1,12,9,3,0,3,3
3008192,1,1,3,3,0,0,0,0
3008192,2,1,6,6,0,0,0,0
3008208,1,1,9,7,2,0,2,1
3008208,3,1,7,8,-1,2,1,1
3008212,1,1,3,3,0,0,0,0
3008212,3,1,2,5,-3,3,0,0
3008280,1,1,10,11,-1,1,0,0
3008280,2,1,4,4,0,0,0,0
3008336,1,1,10,9,1,0,1,1
3008384,1,1,5,4,1,0,1,0
3008384,2,1,6,5,1,0,1,1
3008394,1,1,3,8,-5,5,0,0
3008394,2,1,4,4,0,0,0,0
3008416,1,1,10,10,0,0,0,0
3008416,2,1,13,11,2,2,4,3
3008442,1,1,3,5,-2,2,0,0
3008442,2,1,4,4,0,0,0,0
3008446,1,1,11,2,9,0,9,9
3008446,2,1,12,6,6,0,6,6
3008446,3,1,9,3,6,0,6,6
3008473,1,1,1,3,-2,2,0,0
3008529,1,1,14,13,1,1,2,0
3008529,2,1,16,16,0,0,0,0
3008623,1,1,10,8,2,3,5,5
3008623,2,1,12,9,3,3,6,5
3008665,1,1,5,8,-3,3,0,0
3008665,2,1,5,21,-16,16,0,0
3008673,1,1,6,5,1,0,1,1
3008673,2,1,9,8,1,0,1,1
3008681,1,1,9,10,-1,3,2,2
3008681,2,1,6,6,0,0,0,0
3008722,1,1,11,2,9,0,9,9
3008729,1,1,3,5,-2,3,1,1
3008729,2,1,6,4,2,0,2,2
3008729,3,1,4,2,2,0,2,2
3008730,1,1,8,12,-4,4,0,0
3008783,1,1,2,3,-1,1,0,0
3008814,1,1,4,6,-2,2,0,0
3008814,2,1,6,6,0,0,0,0
3008822,1,1,6,6,0,0,0,0
3008822,2,1,5,2,3,0,3,3
3008822,3,1,1,2,-1,1,0,0
3008858,1,1,1,2,-1,1,0,0
3008858,2,1,5,6,-1,2,1,1
3008862,1,1,13,12,1,1,2,0
3008862,2,1,4,16,-12,12,0,0
3008919,1,1,2,3,-1,1,0,0
3008919,2,1,3,2,1,0,1,0
3008934,1,1,7,5,2,0,2,2
3008934,2,1,1,9,-8,8,0,0
3009219,1,1,0,0,0,0,0,0
3009219,2,1,0,0,0,0,0,0
3009228,1,1,6,6,0,0,0,0
3009228,2,1,6,6,0,0,0,0
3009250,1,1,8,8,0,3,3,0
3009250,2,1,17,6,11,3,14,2
3009250,3,1,0,0,0,0,0,0
3009369,1,1,4,3,1,0,1,0
3009456,1,1,4,5,-1,2,1,1
3009624,1,1,7,6,1,0,1,1
3009624,2,1,10,10,0,0,0,0
3010002,1,1,5,4,1,0,1,0
3010002,2,1,7,6,1,0,1,1
3010028,1,1,5,4,1,0,1,0
3010028,2,1,11,12,-1,1,0,0
3010028,4,1,1,4,-3,3,0,0
3010028,5,1,8,7,1,1,2,0
3010028,6,1,9,7,2,1,3,0
3010061,1,1,4,5,-1,4,3,3
3010061,2,1,10,5,5,0,5,5
3010125,1,1,0,0,0,0,0,0
3010183,1,1,2,2,0,1,1,0
3010183,2,1,5,4,1,0,1,0
3010185,1,1,6,6,0,0,0,0
3010301,1,1,3,3,0,0,0,0
3010441,1,1,0,0,0,0,0,0
3010441,2,1,8,8,0,0,0,0
3010441,4,1,11,10,1,0,1,1
3010463,1,1,2,2,0,0,0,0
3010463,2,1,10,9,1,0,1,0
3010500,1,1,6,6,0,0,0,0
3010500,3,1,4,4,0,0,0,0
3010525,1,1,5,9,-4,4,0,0
3010525,2,1,5,3,2,0,2,2
3010545,1,1,11,6,5,0,5,5
3010545,2,1,4,2,2,0,2,0
3010545,3,1,0,0,0,0,0,0
3010555,1,1,8,8,0,1,1,0
3010555,2,1,3,3,0,0,0,0
3010648,1,1,0,0,0,0,0,0
3010648,2,1,0,0,0,0,0,0
3010648,3,1,0,0,0,0,0,0
3010713,1,1,29,9,20,0,20,3
3010713,2,1,2,2,0,0,0,0
3010766,1,1,3,2,1,1,2,2
3010766,2,1,1,3,-2,2,0,0
3010785,1,1,0,0,0,0,0,0
3010785,2,1,0,0,0,0,0,0
3010808,1,1,4,4,0,0,0,0
3010808,2,1,7,9,-2,2,0,0
3012207,1,1,3,3,0,0,0,0
3012207,2,1,3,3,0,0,0,0
3012810,1,1,2,2,0,0,0,0
3012810,2,1,10,9,1,0,1,1
3012836,1,1,7,4,3,0,3,1
3012836,2,1,1,4,-3,3,0,0
3012892,1,1,5,9,-4,4,0,0
3012892,2,1,2,4,-2,2,0,0
3012905,1,1,0,0,0,0,0,0
3012905,2,1,0,0,0,0,0,0
3013036,1,1,2,5,-3,4,1,1
3013053,1,1,4,4,0,0,0,0
3013053,2,1,7,4,3,0,3,2
3013073,1,1,3,4,-1,1,0,0
3013073,2,1,6,3,3,2,5,3
3013073,3,1,2,2,0,0,0,0
3013195,1,1,4,2,2,0,2,2
3013195,2,1,6,3,3,0,3,3
3013227,1,1,12,11,1,0,1,1
3013230,1,1,10,13,-3,4,1,1
3013230,2,1,14,10,4,1,5,3
3013230,3,1,4,6,-2,2,0,0
3013245,1,1,4,4,0,0,0,0
3013245,2,1,5,5,0,0,0,0
3013261,1,1,0,0,0,0,0,0
3013261,2,1,14,10,4,0,4,2
3013335,1,1,0,0,0,0,0,0
3013335,2,1,0,0,0,0,0,0
3013335,3,1,0,0,0,0,0,0
3013335,4,1,0,0,0,0,0,0
3013515,1,1,5,6,-1,1,0,0
3013515,2,1,0,0,0,0,0,0
3013560,1,1,9,8,1,1,2,2
3013560,2,1,7,7,0,0,0,0
3013706,1,1,9,3,6,0,6,6
3013706,2,1,3,3,0,1,1,1
3013720,1,1,9,9,0,0,0,0
3013720,2,1,2,2,0,0,0,0
3013724,1,1,3,3,0,0,0,0
3013724,2,1,2,2,0,0,0,0
3013724,3,1,7,7,0,0,0,0
3013756,1,1,8,7,1,0,1,1
3013756,2,1,9,9,0,1,1,1
3013756,3,1,8,13,-5,7,2,2
3013756,4,1,5,3,2,1,3,2
3013857,1,1,2,3,-1,1,0,0
3013857,2,1,3,9,-6,7,1,0
3013911,1,1,10,11,-1,1,0,0
3013911,2,1,11,15,-4,6,2,0
3013945,1,1,14,14,0,0,0,0
3013945,2,1,3,3,0,0,0,0
3013996,1,1,12,11,1,0,1,0
3013996,2,1,2,5,-3,3,0,0
3013996,3,1,9,8,1,0,1,0
3014084,1,1,9,6,3,0,3,3
3014084,2,1,2,7,-5,5,0,0
3014132,1,1,9,5,4,1,5,4
3014132,2,1,0,0,0,0,0,0
3014184,1,1,8,9,-1,1,0,0
3014184,2,1,25,25,0,2,2,1
3014694,1,1,6,6,0,0,0,0
3014694,2,1,0,0,0,0,0,0
3014694,3,1,6,6,0,0,0,0
3014702,1,1,3,4,-1,1,0,0
3014746,1,1,1,2,-1,1,0,0
3014746,2,1,3,2,1,0,1,0
3014875,1,1,4,2,2,0,2,0
3014875,2,1,3,5,-2,2,0,0
3015069,1,1,10,9,1,0,1,1
3015069,2,1,0,0,0,0,0,0
3015108,1,1,5,5,0,0,0,0
3015108,2,1,5,5,0,0,0,0
3015252,1,1,4,5,-1,1,0,0
3015270,1,1,1,2,-1,1,0,0
3015270,2,1,2,2,0,0,0,0
3015282,1,1,9,9,0,1,1,1
3015282,2,1,19,12,7,0,7,6
3015282,3,1,6,2,4,0,4,0
3015313,1,1,12,11,1,1,2,2
3015313,2,1,6,6,0,0,0,0
3015313,3,1,1,2,-1,1,0,0
3015369,1,1,4,4,0,0,0,0
3015369,2,1,6,6,0,3,3,3
3015369,3,1,13,4,9,0,9,7
3015386,1,1,5,6,-1,1,0,0
3015471,1,1,4,2,2,0,2,2
3015471,2,1,2,2,0,0,0,0
3015507,1,1,9,7,2,0,2,2
3015532,1,1,0,0,0,0,0,0
3015532,2,1,7,6,1,0,1,1
3015586,1,1,7,9,-2,2,0,0
3015586,2,1,10,9,1,0,1,1
3015610,1,1,6,6,0,0,0,0
3015610,2,1,8,8,0,0,0,0
3015610,3,1,5,4,1,0,1,0
3015625,1,1,4,4,0,2,2,1
3015625,2,1,5,4,1,1,2,2
3015655,1,1,4,4,0,0,0,0
3015655,2,1,3,5,-2,2,0,0
3015696,1,1,6,4,2,0,2,1
3015696,2,1,2,2,0,0,0,0
3015737,1,1,1,3,-2,2,0,0
3015737,2,1,13,5,8,0,8,7
3015737,3,1,6,3,3,0,3,1
3015737,4,1,3,2,1,0,1,0
3015830,1,1,1,5,-4,4,0,0
3015830,3,1,2,2,0,0,0,0
3015913,1,1,7,7,0,1,1,1
3015913,2,1,9,6,3,1,4,4
3016440,1,1,14,12,2,1,3,0
3016446,1,1,5,6,-1,1,0,0
3016446,2,1,3,3,0,0,0,0
3016447,1,1,4,12,-8,8,0,0
3016447,2,1,8,9,-1,2,1,1
3016447,3,1,9,7,2,0,2,2
3016447,4,1,29,5,24,0,24,21
3016765,1,1,7,6,1,2,3,2
3016765,2,1,10,9,1,4,5,5
3016765,3,1,13,6,7,1,8,2
3016854,1,1,2,2,0,0,0,0
3016854,2,1,3,2,1,0,1,1
3016918,1,1,2,2,0,0,0,0
3016918,2,1,11,9,2,0,2,0
3016918,3,1,8,4,4,0,4,1
3016923,1,1,5,5,0,0,0,0
3016923,2,1,0,0,0,0,0,0
3016925,1,1,0,0,0,0,0,0
3016982,1,1,7,7,0,0,0,0
3017057,1,1,2,2,0,0,0,0
3017057,2,1,5,6,-1,1,0,0
3017082,1,1,0,0,0,0,0,0
3017082,2,1,5,6,-1,2,1,1
3017082,3,1,7,6,1,0,1,1
3017082,4,1,3,4,-1,1,0,0
3017387,1,1,2,2,0,0,0,0
3017460,2,1,4,2,2,0,2,2
3017503,1,1,4,4,0,0,0,0
3017503,2,1,0,0,0,0,0,0
3017509,1,1,8,6,2,0,2,0
3017539,1,1,5,8,-3,3,0,0
3017539,2,1,6,5,1,2,3,3
3017561,2,1,9,5,4,0,4,0
3017561,3,1,0,0,0,0,0,0
3017575,1,1,5,3,2,0,2,2
3017597,1,1,10,8,2,0,2,1
3017626,1,1,4,4,0,0,0,0
3017626,2,1,3,4,-1,1,0,0
3017721,1,1,2,6,-4,4,0,0
3017721,2,1,3,7,-4,4,0,0
3017726,2,1,12,12,0,2,2,2
3017726,3,1,12,5,7,0,7,0
3017740,1,1,10,8,2,0,2,2
3017854,1,1,6,4,2,0,2,2
3017854,2,1,0,0,0,0,0,0
3017884,1,1,12,8,4,0,4,4
3017884,2,1,4,4,0,0,0,0
3017895,1,1,11,6,5,0,5,4
3017895,2,1,10,9,1,0,1,1
3017973,1,1,14,12,2,0,2,2
3017973,2,1,9,10,-1,1,0,0
3018288,1,1,2,2,0,0,0,0
3018288,2,1,6,5,1,0,1,1
3018342,1,1,8,8,0,0,0,0
3018342,3,1,10,10,0,0,0,0
3018378,1,1,4,2,2,0,2,1
3018378,2,1,6,4,2,0,4,2
3018400,1,1,0,0,0,0,0,0
3018400,2,1,8,5,3,0,3,3
3018484,1,1,2,2,0,0,0,0
3018484,2,1,3,2,1,0,1,1
3018684,1,1,6,6,0,0,0,0
3018684,2,1,6,6,0,0,0,0
3018830,2,1,9,6,3,0,3,3
3018830,3,1,9,4,5,1,6,6
3019043,1,1,10,12,-2,2,0,0
3019043,2,1,5,5,0,0,0,0
3019043,3,1,9,4,5,0,5,5
3019043,4,1,8,7,1,0,1,1
3019142,1,1,2,2,0,0,0,0
3019142,2,1,10,8,2,0,2,0
3019157,1,1,5,7,-2,2,0,0
3019157,2,1,2,2,0,0,0,0
3019157,3,1,2,2,0,0,0,0
3019157,4,1,0,0,0,0,0,0
3019185,1,1,12,11,1,0,1,1
3019185,2,1,4,5,-1,1,0,0
3019185,3,1,5,5,0,0,0,0
3019326,1,1,9,7,2,0,2,2
3019326,2,1,3,4,-1,1,0,0
3019326,3,1,3,2,1,0,1,1
3019326,4,1,2,2,0,0,0,0
3019368,1,1,0,0,0,0,0,0
3019368,2,1,2,3,-1,1,0,0
3019368,3,1,13,6,7,0,7,0
3019415,1,1,5,4,1,0,1,1
3019415,2,1,2,2,0,0,0,0
3019427,1,1,3,3,0,0,0,0
3019433,1,1,5,4,1,1,2,2
3019433,2,1,7,2,5,0,5,4
3019445,1,1,5,2,3,0,3,3
3019445,2,1,1,1,0,0,0,0
3019550,1,1,4,4,0,0,0,0
3019550,2,1,2,4,-2,2,0,0
3019555,1,1,4,2,2,0,2,1
3019555,2,1,9,6,3,0,3,1
3019555,3,1,8,5,3,0,3,0
3019574,1,1,2,2,0,0,0,0
3019574,3,1,5,3,2,0,2,2
3019574,4,1,8,2,6,0,6,5
3019633,2,1,8,2,6,0,6,4
3019633,3,1,8,2,6,0,6,6
3019653,1,1,3,3,0,0,0,0
3019653,2,1,5,4,1,0,1,1
3019707,1,1,8,7,1,0,1,0
3019707,2,1,16,7,9,0,9,8
3019707,3,1,2,4,-2,2,0,0
3019766,1,1,10,10,0,1,1,0
3019766,2,1,8,7,1,0,1,0
3019936,1,1,3,3,0,0,0,0
3019936,2,1,4,2,2,0,2,0
3019994,1,1,5,6,-1,3,2,2
3019994,2,1,19,7,12,3,15,15
3019997,1,1,10,6,4,0,4,0
3019997,2,1,4,4,0,0,0,0
3020103,1,1,4,2,2,0,2,2
3020103,2,1,4,2,2,0,2,2
3020131,1,1,10,12,-2,2,0,0
3020131,5,1,4,0,4,0,4,0
3020142,1,1,3,6,-3,3,0,0
3020142,2,1,1,2,-1,1,0,0
3020205,1,1,4,4,0,0,0,0
3020205,2,1,0,0,0,0,0,0
3020219,1,1,0,0,0,0,0,0
3020219,4,1,0,0,0,0,0,0
3020272,1,1,11,11,0,0,0,0
3020272,2,1,9,7,2,0,2,2
3020272,3,1,4,4,0,0,0,0
3020296,1,1,10,9,1,0,1,0
3020314,1,1,3,5,-2,3,1,1
3020314,2,1,8,5,3,0,3,3
3020479,1,1,3,5,-2,2,0,0
3020479,2,1,7,7,0,0,0,0
3020522,1,1,3,3,0,0,0,0
3020522,2,1,2,2,0,0,0,0
3020541,1,1,2,2,0,0,0,0
3020598,1,1,2,4,-2,2,0,0
3020598,2,1,4,4,0,0,0,0
3020599,1,1,13,13,0,0,0,0
3020620,1,1,6,6,0,0,0,0
3020620,2,1,7,6,1,0,1,0
3020620,3,1,7,5,2,0,2,0
3020658,2,1,3,3,0,0,0,0
3020668,1,1,2,2,0,0,0,0
3020668,2,1,6,5,1,0,1,1
3020675,1,1,3,3,0,0,0,0
3020675,2,1,3,3,0,0,0,0
3020749,1,1,4,4,0,2,2,2
3020749,2,1,6,6,0,1,1,0
3020749,3,1,2,2,0,0,0,0
3020797,1,1,7,7,0,0,0,0
3020797,2,1,6,8,-2,2,0,0
3020800,1,1,9,6,3,1,4,0
3020800,2,1,8,7,1,0,1,1
3020823,1,1,4,2,2,0,2,2
3020823,2,1,2,2,0,0,0,0
3020841,1,1,10,3,7,0,7,7
3020918,1,1,7,5,2,0,2,2
3020918,2,1,7,5,2,1,3,2
3020920,1,1,4,2,2,0,2,0
3020921,1,1,4,4,0,0,0,0
3020921,2,1,0,0,0,0,0,0
3020952,1,1,4,14,-10,11,1,0
3020952,2,1,14,10,4,0,4,4
3020967,1,1,7,2,5,1,6,0
3020967,2,1,0,0,0,0,0,0
3020967,3,1,1,2,-1,1,0,0
3020967,4,1,3,2,1,0,1,1
3021028,1,1,0,0,0,0,0,0
3021028,2,1,0,0,0,0,0,0
3021028,3,1,0,0,0,0,0,0
3021103,1,1,0,0,0,0,0,0
3021103,2,1,0,0,0,0,0,0
3021103,5,1,0,0,0,0,0,0
3021184,1,1,13,4,9,0,9,9
3021184,2,1,9,2,7,0,7,7
3021198,1,1,10,9,1,5,6,0
3021198,2,1,4,7,-3,3,0,0
3021230,1,1,8,3,5,0,5,4
3021381,1,1,2,2,0,0,0,0
3021381,2,1,15,13,2,0,2,2
3021440,1,1,6,5,1,0,1,1
3021440,2,1,6,4,2,0,2,2
3021459,1,1,5,6,-1,4,3,3
3021459,2,1,6,7,-1,1,0,0
3021556,1,1,11,11,0,0,0,0
3021556,2,1,13,10,3,0,3,0
3021795,1,1,4,5,-1,1,0,0
3021795,2,1,9,2,7,0,7,7
3021795,3,1,2,2,0,0,0,0
3021795,4,1,2,2,0,0,0,0
3021946,1,1,2,4,-2,2,0,0
3021946,2,1,6,8,-2,2,0,0
3021968,1,1,6,5,1,0,1,1
3021968,2,1,0,0,0,0,0,0
3022035,1,1,3,3,0,0,0,0
3022035,2,1,9,5,4,2,6,6
3022035,3,1,3,3,0,0,0,0
3022308,1,1,10,9,1,2,3,3
3022506,1,1,6,5,1,0,1,1
3022524,2,1,3,2,1,0,1,0
3022593,1,1,6,5,1,0,1,1
3022593,2,1,4,2,2,0,2,0
3022731,1,1,6,3,3,0,3,3
3022731,2,1,6,2,4,0,4,4
3022750,1,1,8,10,-2,3,1,1
3022750,2,1,3,2,1,0,1,1
3022864,1,1,9,8,1,0,1,1
3023076,1,1,9,8,1,1,2,1
3023121,2,1,0,0,0,0,0,0
3023121,3,1,2,2,0,0,0,0
3023246,1,1,14,6,8,0,8,8
3023246,2,1,7,2,5,0,5,4
3023246,3,1,1,11,-10,10,0,0
3023246,4,1,0,0,0,0,0,0
3023316,1,1,7,8,-1,1,0,0
3023316,2,1,2,2,0,0,0,0
3023388,1,1,3,3,0,0,0,0
3023388,2,1,3,3,0,0,0,0
3023458,1,1,2,4,-2,3,1,1
3023458,2,1,9,5,4,0,4,4
3023458,3,1,8,2,6,0,6,6
3023579,1,1,10,10,0,0,0,0
3023579,2,1,2,3,-1,1,0,0
3023688,1,1,4,4,0,0,0,0
3023688,2,1,1,4,-3,3,0,0
3023736,1,1,6,5,1,0,1,1
3023736,2,1,3,3,0,0,0,0
3023762,1,1,4,4,0,0,0,0
3023762,2,1,9,9,0,0,0,0
3023969,2,1,3,2,1,0,1,1
3023969,4,1,0,0,0,0,0,0
3024077,1,1,2,2,0,0,0,0
3024077,2,1,0,0,0,0,0,0
3024077,3,1,0,0,0,0,0,0
3034521,1,1,6,4,2,0,2,1
3051054,1,1,13,11,2,0,2,1
3051054,2,1,0,0,0,0,0,0
3051083,1,1,0,0,0,0,0,0
3051083,2,1,11,4,7,0,7,7
3051199,1,1,4,6,-2,4,2,2
3051199,2,1,11,5,6,0,6,1
3051935,1,1,11,11,0,0,0,0
3051935,2,1,3,2,1,0,1,1
3051935,3,1,0,0,0,0,0,0
3055902,1,1,9,7,2,2,4,3
3055902,2,1,0,0,0,0,0,0
3056139,1,1,8,9,-1,2,1,1
3056139,2,1,10,12,-2,2,0,0
3056470,1,1,6,4,2,0,2,2
3056470,2,1,6,3,3,0,3,3
3056608,1,1,2,2,0,0,0,0
3056620,1,1,6,5,1,0,1,1
3056620,2,1,7,8,-1,2,1,1
3056679,1,1,6,7,-1,4,3,3
3056679,2,1,0,0,0,0,0,0
3056679,3,1,6,2,4,0,4,4
3056754,1,1,7,7,0,0,0,0
3056754,2,1,7,7,0,0,0,0
3056754,3,1,7,6,1,0,1,1
3056754,4,1,7,7,0,0,0,0
3056913,1,1,4,4,0,0,0,0
3056913,2,1,2,2,0,0,0,0
3057139,1,1,6,6,0,0,0,0
3057139,2,1,15,6,9,0,9,0
3057178,1,1,5,4,1,0,1,1
3057178,2,1,5,4,1,0,1,1
3057178,3,1,5,4,1,0,1,1
3072829,1,1,7,8,-1,1,0,0
3072829,2,1,5,3,2,0,2,1
3072829,3,1,13,13,0,0,0,0
3081031,1,1,16,5,11,0,11,9
3081031,2,1,0,0,0,0,0,0
7007607,1,1,0,0,0,0,0,0
7007611,1,1,2,2,0,0,0,0
7007611,2,1,6,7,-1,1,0,0
7007651,1,1,4,6,-2,2,0,0
7007651,2,1,4,4,0,0,0,0
7007651,3,1,8,8,0,0,0,0
7007817,1,1,0,0,0,0,0,0
7007831,1,1,0,0,0,0,0,0
7007831,2,1,4,5,-1,1,0,0
7007838,1,1,1,2,-1,1,0,0
7007838,2,1,2,2,0,0,0,0
7007863,1,1,8,3,5,0,5,4
7007863,2,1,8,4,4,0,4,4
7007865,1,1,4,14,-10,10,0,0
7007865,2,1,7,7,0,0,0,0
7007867,1,1,2,4,-2,2,0,0
7007867,2,1,0,0,0,0,0,0
7007957,1,1,6,4,2,0,2,0
7007969,1,1,4,4,0,0,0,0
7007969,2,1,5,6,-1,1,0,0
7008003,1,1,6,6,0,0,0,0
7008003,2,1,5,4,1,0,1,0
7008068,1,1,8,8,0,0,0,0
7008068,2,1,6,7,-1,1,0,0
7008083,1,1,3,6,-3,4,1,0
7008115,1,1,7,6,1,0,1,1
7008115,2,1,5,5,0,0,0,0
7008149,1,1,7,7,0,0,0,0
7008149,2,1,4,5,-1,1,0,0
7009032,1,1,2,5,-3,3,0,0
7009132,1,1,6,6,0,2,2,2
7009132,2,1,2,2,0,0,0,0
7009251,1,1,6,5,1,0,1,1
7009251,3,1,2,2,0,0,0,0
7009337,1,1,0,0,0,0,0,0
7009337,2,1,0,0,0,0,0,0
7009337,3,1,0,0,0,0,0,0
7009337,4,1,0,0,0,0,0,0
7009401,1,1,3,2,1,0,1,1
7009401,2,1,7,4,3,0,3,0
7009578,1,1,4,4,0,0,0,0
7009578,2,1,5,5,0,1,1,1
7009712,1,1,7,5,2,0,2,1
7009727,1,1,7,6,1,0,1,0
7009727,2,1,9,8,1,0,1,0
7009727,3,1,4,4,0,0,0,0
7009909,1,1,4,6,-2,2,0,0
7009941,1,1,3,2,1,0,1,1
7009941,2,1,3,5,-2,2,0,0
7009941,4,1,1,2,-1,1,0,0
7009957,1,1,7,7,0,0,0,0
7010035,1,1,8,7,1,0,1,1
7010035,2,1,10,8,2,0,2,2
7010035,3,1,3,3,0,0,0,0
7010144,1,1,5,4,1,0,1,0
7010144,2,1,3,5,-2,2,0,0
7010317,1,1,8,10,-2,2,0,0
7010317,2,1,0,0,0,0,0,0
7010654,1,1,0,0,0,0,0,0
7010654,2,1,4,2,2,0,2,2
7010654,3,1,9,2,7,0,7,5
7010707,2,1,3,4,-1,1,0,0
7010742,1,1,19,13,6,0,6,6
7010742,2,1,5,2,3,0,3,3
7010773,1,1,9,9,0,0,0,0
7010773,2,1,8,8,0,0,0,0
7010773,3,1,1,2,-1,1,0,0
7011115,1,1,5,2,3,0,3,3
7011115,3,1,6,7,-1,3,2,2
7011115,4,1,13,6,7,0,7,5
7011115,5,1,6,4,2,2,4,4
7011126,1,1,17,17,0,0,0,0
7011126,2,1,5,5,0,0,0,0
7011292,1,1,5,5,0,0,0,0
7011292,2,1,8,7,1,0,1,1
7011297,1,1,4,4,0,2,2,2
7011503,1,1,0,0,0,0,0,0
7011503,2,1,19,2,17,0,17,6
7011574,1,1,3,4,-1,1,0,0
7011629,2,1,5,6,-1,1,0,0
7011713,1,1,0,0,0,0,0,0
7011713,2,1,0,0,0,0,0,0
7011713,3,1,0,0,0,0,0,0
7011807,1,1,0,0,0,0,0,0
7011807,2,1,6,6,0,0,0,0
7011883,1,1,19,14,5,2,7,7
7011883,4,1,6,6,0,1,1,1
7011934,1,1,4,4,0,0,0,0
7011934,2,1,2,2,0,0,0,0
7011978,1,1,8,6,2,0,2,2
7011978,2,1,5,5,0,0,0,0
7012116,1,1,13,4,9,0,9,0
7012116,2,1,10,9,1,0,1,1
7012116,3,1,9,4,5,0,5,0
7012179,1,1,3,3,0,0,0,0
7012179,2,1,4,4,0,0,0,0
7012230,1,1,2,2,0,0,0,0
7012230,2,1,2,2,0,0,0,0
7012318,1,1,6,9,-3,5,2,1
7012400,1,1,0,0,0,0,0,0
7012400,2,1,8,2,6,0,6,3
7012454,1,1,8,6,2,0,2,2
7012454,2,1,9,6,3,0,3,3
7012454,3,1,3,7,-4,4,0,0
7012780,1,1,7,5,2,0,2,2
7012780,2,1,2,2,0,0,0,0
7012782,1,1,3,3,0,0,0,0
7012908,1,1,11,9,2,1,3,0
7012908,2,1,6,4,2,0,2,1
7012908,3,1,5,3,2,0,2,1
7012946,1,1,4,4,0,0,0,0
7013004,2,1,5,5,0,1,1,1
7013037,1,1,2,2,0,0,0,0
7013291,2,1,2,2,0,0,0,0
7013379,1,1,3,3,0,0,0,0
7013379,2,1,0,0,0,0,0,0
7013640,1,1,0,0,0,0,0,0
7013823,1,1,5,6,-1,2,1,0
7014051,1,1,2,6,-4,4,0,0
7014385,1,1,6,8,-2,2,0,0
7014401,1,1,6,9,-3,3,0,0
7014405,1,1,7,7,0,1,1,1
7014449,2,1,3,4,-1,2,1,1
7014464,2,1,0,0,0,0,0,0
7014476,1,1,10,6,4,5,9,9
7014476,2,1,3,2,1,1,2,2
7014476,3,1,3,4,-1,2,1,1
7014525,1,1,3,9,-6,6,0,0
7014611,1,1,20,16,4,1,5,5
7014611,2,1,10,9,1,1,2,2
7014614,1,1,4,5,-1,2,1,1
7014614,2,1,2,2,0,1,1,1
7014614,3,1,6,8,-2,2,0,0
7014647,1,1,0,0,0,0,0,0
7014665,1,1,7,3,4,0,4,0
7014665,2,1,9,5,4,0,4,0
7014667,1,1,3,17,-14,15,1,0
7014667,2,1,9,8,1,2,3,2
7014692,1,1,2,2,0,0,0,0
7014692,2,1,0,0,0,0,0,0
7014713,1,1,2,6,-4,4,0,0
7014726,1,1,4,4,0,0,0,0
7014726,2,1,1,2,-1,1,0,0
7014758,1,1,7,10,-3,3,0,0
7014758,2,1,2,4,-2,2,0,0
7015084,1,1,7,7,0,0,0,0
7015084,2,1,3,6,-3,3,0,0
7015209,1,1,9,11,-2,2,0,0
7015209,2,1,0,0,0,0,0,0
7015279,1,1,1,2,-1,1,0,0
7015279,2,1,5,8,-3,3,0,0
7015279,3,1,17,15,2,0,2,1
7015430,1,1,0,0,0,0,0,0
7015478,1,1,9,7,2,0,2,2
7015478,2,1,5,4,1,0,1,1
7015549,1,1,6,5,1,0,1,1
7015549,2,1,4,4,0,0,0,0
7015630,1,1,5,8,-3,3,0,0
7015630,2,1,10,7,3,0,3,3
7015646,1,1,8,6,2,0,2,2
7015646,2,1,8,6,2,0,2,1
7015646,3,1,3,5,-2,2,0,0
7015647,1,1,5,12,-7,8,1,1
7015647,2,1,8,6,2,0,2,2
7016454,1,1,6,6,0,0,0,0
7016478,1,1,17,16,1,3,4,4
7016485,1,1,7,7,0,0,0,0
7016485,2,1,8,8,0,0,0,0
7016551,1,1,10,11,-1,2,1,1
7016552,1,1,5,7,-2,2,0,0
7016552,2,1,11,11,0,1,1,1
7016607,1,1,7,10,-3,3,0,0
7016607,2,1,2,8,-6,6,0,0
7016667,1,1,7,10,-3,4,1,1
7016667,2,1,6,7,-1,2,1,1
7016828,1,1,4,4,0,0,0,0
7016828,3,1,9,6,3,1,4,2
7016929,1,1,0,0,0,0,0,0
7016929,2,1,8,7,1,1,2,2
7016978,1,1,2,6,-4,4,0,0
7017104,1,1,6,4,2,0,2,2
7017104,2,1,5,4,1,2,3,3
7017181,1,1,10,9,1,0,1,1
7017181,2,1,4,6,-2,4,2,2
7017241,1,1,25,9,16,1,17,5
7017308,1,1,8,8,0,2,2,2
7017593,1,1,6,5,1,2,3,0
7017593,2,1,6,4,2,0,2,2
7017644,1,1,0,0,0,0,0,0
7017644,2,1,0,0,0,0,0,0
7017644,3,1,0,0,0,0,0,0
7017644,4,1,6,6,0,0,0,0
7017644,5,1,0,0,0,0,0,0
7017673,1,1,0,0,0,0,0,0
7017673,2,1,4,4,0,0,0,0
7018091,1,1,5,5,0,0,0,0
7018091,2,1,8,6,2,0,2,0
7018181,1,1,0,0,0,0,0,0
7018181,2,1,0,0,0,0,0,0
7018216,1,1,8,12,-4,7,3,3
7018216,2,1,3,4,-1,1,0,0
7018256,1,1,2,10,-8,8,0,0
7018256,2,1,6,9,-3,3,0,0
7018295,1,1,9,6,3,0,3,3
7018316,1,1,0,0,0,0,0,0
7018393,1,1,4,4,0,0,0,0
7018393,2,1,2,2,0,0,0,0
7018393,3,1,6,6,0,0,0,0
7018393,4,1,6,4,2,0,2,2
7018489,1,1,12,10,2,0,2,2
7018489,2,1,6,6,0,0,0,0
7018520,1,1,4,4,0,0,0,0
7018622,1,1,13,12,1,1,2,2
7018622,2,1,9,6,3,0,3,1
7018794,1,1,7,7,0,0,0,0
7018855,1,1,9,7,2,1,3,3
7018883,1,1,9,6,3,0,3,3
7018891,1,1,1,4,-3,3,0,0
7018891,2,1,2,2,0,0,0,0
7018983,1,1,4,10,-6,7,1,1
7019067,1,1,2,2,0,0,0,0
7019243,1,1,2,2,0,0,0,0
7019243,2,1,7,12,-5,7,2,2
7019270,1,1,4,4,0,0,0,0
7019270,2,1,9,4,5,0,5,4
7019283,1,1,7,8,-1,1,0,0
7019283,2,1,2,3,-1,1,0,0
7019383,1,1,12,6,6,1,7,7
7019383,2,1,6,4,2,0,2,2
7019392,1,1,6,2,4,1,5,5
7019392,2,1,4,3,1,0,1,1
7019440,1,1,2,2,0,0,0,0
7019440,2,1,4,3,1,1,2,2
7019542,1,1,8,9,-1,1,0,0
7019676,1,1,0,0,0,0,0,0
7019802,1,1,6,8,-2,2,0,0
7019823,1,1,9,11,-2,2,0,0
7019823,2,1,3,6,-3,3,0,0
7019827,1,1,8,6,2,0,2,2
7019827,2,1,4,5,-1,2,1,1
7019827,3,1,3,3,0,0,0,0
7019863,1,1,7,6,1,0,1,0
7019863,2,1,7,4,3,1,4,4
7019863,3,1,0,0,0,0,0,0
7020181,1,1,5,7,-2,2,0,0
7020234,1,1,0,0,0,0,0,0
7020247,1,1,9,8,1,2,3,1
7020254,1,1,14,14,0,0,0,0
7020254,2,1,17,15,2,0,2,1
7020281,1,1,6,9,-3,4,1,0
7020281,2,1,3,2,1,0,1,0
7020353,1,1,0,0,0,0,0,0
7020353,2,1,7,6,1,0,1,1
7020353,3,1,2,2,0,0,0,0
7020353,4,1,2,2,0,0,0,0
7020457,1,1,8,8,0,0,0,0
7020457,2,1,4,4,0,0,0,0
7020457,3,1,4,4,0,0,0,0
7020523,1,1,3,3,0,0,0,0
7020523,2,1,2,2,0,0,0,0
7020622,1,1,4,4,0,0,0,0
7020622,2,1,4,4,0,0,0,0
7020745,1,1,0,0,0,0,0,0
7020760,1,1,6,6,0,0,0,0
7020760,2,1,4,4,0,0,0,0
7020908,1,1,6,4,2,0,2,2
7020908,2,1,1,6,-5,5,0,0
7157658,1,1,1,6,-5,5,0,0
7157658,2,1,11,11,0,0,0,0
7157658,3,1,3,3,0,0,0,0
7157693,1,1,9,7,2,0,2,2
7157912,1,1,11,10,1,0,1,1
7157912,2,1,2,3,-1,1,0,0
7157912,3,1,2,3,-1,1,0,0
7157924,1,1,4,2,2,0,2,2
7157924,2,1,4,3,1,0,1,1
7158174,1,1,2,5,-3,3,0,0
7158604,1,1,1,8,-7,7,0,0
7158604,2,1,6,6,0,0,0,0
7158844,1,1,1,5,-4,4,0,0
7158844,2,1,3,2,1,0,1,0
7158844,3,1,3,2,1,0,1,0
7158844,4,1,3,2,1,0,1,1
7158852,2,1,9,8,1,1,2,2
7158870,1,1,4,4,0,0,0,0
7158870,2,1,12,11,1,0,1,1
7158876,1,1,7,4,3,0,3,3
7158876,2,1,13,6,7,0,7,7
7158898,1,1,6,6,0,0,0,0
7158898,2,1,9,10,-1,1,0,0
7158911,1,1,3,2,1,0,1,0
7158911,2,1,5,4,1,0,1,0
7158975,1,1,4,4,0,0,0,0
7158975,2,1,1,4,-3,3,0,0
7159081,2,1,5,4,1,0,1,1
7159081,3,1,2,4,-2,2,0,0
7159089,1,1,9,9,0,0,0,0
7159089,2,1,0,0,0,0,0,0
7159112,1,1,2,4,-2,2,0,0
7159123,2,1,9,6,3,1,4,3
7159331,1,1,9,7,2,2,4,4
7159331,2,1,5,3,2,0,2,2
7159331,3,1,3,3,0,0,0,0
7159381,1,1,11,9,2,0,2,2
7159381,2,1,2,3,-1,1,0,0
7159381,3,1,5,3,2,0,2,2
7159381,4,1,4,4,0,0,0,0
7159535,1,1,3,2,1,0,1,1
7159535,2,1,5,5,0,0,0,0
7159584,1,1,3,3,0,0,0,0
7159594,1,1,1,12,-11,11,0,0
7159594,2,1,6,2,4,0,4,4
7159597,1,1,2,6,-4,4,0,0
7159597,2,1,9,9,0,0,0,0
7159612,1,1,2,2,0,0,0,0
7159612,2,1,2,2,0,0,0,0
7159612,3,1,2,2,0,0,0,0
7159612,4,1,2,2,0,0,0,0
7159633,1,1,14,3,11,0,11,11
7159633,2,1,8,6,2,0,2,2
7159644,1,1,11,8,3,0,3,2
7159644,2,1,3,4,-1,1,0,0
7159644,3,1,2,4,-2,2,0,0
7159650,1,1,9,9,0,0,0,0
7159698,1,1,0,0,0,0,0,0
7159698,3,1,0,0,0,0,0,0
7159698,4,1,0,0,0,0,0,0
7159983,2,1,3,2,1,1,2,2
7160000,1,1,0,0,0,0,0,0
7160000,2,1,7,6,1,0,1,1
7160000,3,1,5,4,1,0,1,1
7160000,4,1,9,17,-8,9,1,1
7160087,2,1,5,5,0,0,0,0
7160087,3,1,9,3,6,0,6,6
7160251,1,1,4,5,-1,3,2,2
7160251,2,1,3,3,0,0,0,0
7160251,3,1,5,4,1,0,1,0
7160267,1,1,5,4,1,0,1,0
7160267,2,1,5,5,0,0,0,0
7160271,1,1,13,13,0,2,2,0
7160271,2,1,3,3,0,0,0,0
7160637,1,1,11,8,3,1,4,2
7160637,2,1,2,2,0,0,0,0
7160637,3,1,7,6,1,0,1,1
7161097,1,1,6,8,-2,2,0,0
7161097,2,1,3,4,-1,1,0,0
7161097,3,1,6,5,1,0,1,1
7161536,2,1,4,2,2,0,2,2
7161536,5,1,0,0,0,0,0,0
7161591,1,1,0,0,0,0,0,0
7161591,2,1,0,0,0,0,0,0
7161670,1,1,0,0,0,0,0,0
7161670,2,1,2,2,0,0,0,0
7161670,3,1,3,2,1,0,1,1
7161671,1,1,2,2,0,0,0,0
7161671,2,1,2,4,-2,2,0,0
7161671,3,1,19,12,7,0,7,7
7161683,1,1,6,6,0,0,0,0
7161683,2,1,3,3,0,0,0,0
7161839,1,1,11,5,6,0,6,6
7161839,2,1,7,7,0,0,0,0
7161839,3,1,4,4,0,0,0,0
7161841,1,1,4,4,0,0,0,0
7161841,2,1,8,6,2,0,2,2
7161841,3,1,1,4,-3,3,0,0
7161892,1,1,3,2,1,0,1,1
7161892,2,1,10,4,6,0,6,3
7161892,3,1,5,5,0,0,0,0
7161892,4,1,3,4,-1,2,1,0
7162121,1,1,6,6,0,2,2,2
7162320,1,1,17,12,5,1,6,6
7162320,2,1,15,14,1,1,2,2
7162531,1,1,25,21,4,4,8,1
7162531,2,1,8,6,2,0,2,2
7162619,1,1,0,0,0,0,0,0
7162626,1,1,5,11,-6,6,0,0
7162626,3,1,6,11,-5,6,1,1
7162686,1,1,3,8,-5,5,0,0
7162686,2,1,14,3,11,0,11,11
7162928,1,1,1,3,-2,2,0,0
7162928,2,1,5,5,0,0,0,0
7162964,1,1,1,2,-1,1,0,0
7162964,2,1,14,15,-1,1,0,0
7162973,1,1,9,2,7,0,7,6
7163082,1,1,7,5,2,0,2,1
7163193,1,1,4,10,-6,6,0,0
7163193,2,1,7,10,-3,3,0,0
7163216,1,1,6,1,5,0,5,4
7163216,2,1,0,0,0,0,0,0
7163216,3,1,0,0,0,0,0,0
7163216,4,1,2,4,-2,2,0,0
7163238,1,1,2,2,0,0,0,0
7163238,2,1,3,3,0,0,0,0
7163480,2,1,0,0,0,0,0,0
7163555,1,1,5,5,0,0,0,0
7163555,2,1,7,6,1,1,2,2
7163582,1,1,5,5,0,0,0,0
7163582,2,1,0,0,0,0,0,0
7163613,1,1,0,0,0,0,0,0
7163613,3,1,0,0,0,0,0,0
7163640,1,1,6,4,2,0,2,2
7163640,2,1,2,4,-2,2,0,0
7163673,1,1,4,9,-5,5,0,0
7163689,1,1,0,0,0,0,0,0
7163689,2,1,0,0,0,0,0,0
7163711,1,1,2,2,0,0,0,0
7163711,2,1,1,2,-1,1,0,0
7163730,1,1,12,13,-1,1,0,0
7163875,1,1,1,2,-1,1,0,0
7163875,3,1,0,0,0,0,0,0
7163889,1,1,18,7,11,0,11,11
7163889,2,1,3,3,0,0,0,0
7163889,3,1,33,3,30,0,30,1
7163889,4,1,3,2,1,1,2,2
7164122,1,1,2,2,0,0,0,0
7164122,2,1,2,2,0,0,0,0
7164171,1,1,0,0,0,0,0,0
7164171,5,1,3,2,1,0,1,1
7164210,2,1,2,3,-1,1,0,0
7164210,3,1,7,5,2,0,2,2
7164378,1,1,4,4,0,0,0,0
7164378,2,1,9,8,1,1,2,2
7164378,3,1,2,2,0,0,0,0
7164449,1,1,6,4,2,0,2,2
7164449,2,1,2,4,-2,2,0,0
7164511,1,1,0,0,0,0,0,0
7164607,1,1,8,4,4,0,4,4
7164700,1,1,8,5,3,1,4,4
7164700,2,1,2,2,0,0,0,0
7164700,3,1,2,2,0,0,0,0
7164700,4,1,6,3,3,0,3,3
7164782,1,1,4,4,0,1,1,1
7164782,2,1,5,7,-2,2,0,0
7164822,1,1,4,5,-1,2,1,1
7164822,2,1,9,8,1,1,2,2
7164991,1,1,8,8,0,0,0,0
7164991,2,1,13,14,-1,5,4,4
7165313,1,1,5,5,0,0,0,0
7165313,2,1,3,2,1,0,1,0
7165339,2,1,0,0,0,0,0,0
7165339,3,1,5,10,-5,5,0,0
7165367,1,1,3,2,1,0,1,0
7165367,2,1,2,2,0,0,0,0
7165410,1,1,3,3,0,0,0,0
7165410,2,1,4,3,1,0,1,1
7165410,4,1,0,0,0,0,0,0
7165470,1,1,2,2,0,0,0,0
7165506,1,1,3,6,-3,3,0,0
7165506,2,1,3,9,-6,6,0,0
7165506,3,1,6,5,1,1,2,2
7165540,1,1,0,0,0,0,0,0
7165540,2,1,8,13,-5,5,0,0
7165553,2,1,4,4,0,0,0,0
7165553,4,1,2,2,0,0,0,0
7165553,5,1,8,6,2,0,2,1
7165849,1,1,2,2,0,0,0,0
7165849,2,1,5,5,0,0,0,0
7165911,1,1,1,2,-1,1,0,0
7165911,2,1,10,7,3,0,3,3
7165913,1,1,2,4,-2,2,0,0
7165913,2,1,0,0,0,0,0,0
7165913,3,1,0,0,0,0,0,0
7165934,1,1,14,11,3,0,3,2
7165934,2,1,8,7,1,0,1,1
7165941,1,1,4,4,0,0,0,0
7165941,2,1,22,10,12,2,14,0
7165941,3,1,5,4,1,0,1,1
7165943,1,1,2,2,0,0,0,0
7165943,2,1,2,2,0,0,0,0
7165943,3,1,9,5,4,1,5,5
7165949,1,1,7,6,1,0,1,1
7165949,2,1,26,24,2,0,2,1
7165949,3,1,1,5,-4,4,0,0
7165950,1,1,3,4,-1,2,1,1
7165950,2,1,5,3,2,0,2,1
7165950,3,1,10,3,7,0,7,6
7165950,4,1,3,2,1,0,1,1
7166412,1,1,11,11,0,2,2,2
7166412,2,1,6,8,-2,3,1,1
7166412,3,1,12,10,2,1,3,2
7166528,1,1,3,6,-3,3,0,0
7166678,1,1,10,10,0,0,0,0
7166678,2,1,3,4,-1,1,0,0
7166678,3,1,5,5,0,0,0,0
7166712,1,1,6,5,1,0,1,1
7166712,2,1,8,4,4,0,4,4
7166712,3,1,4,4,0,0,0,0
7166726,1,1,6,2,4,0,4,4
7166734,1,1,6,2,4,0,4,3
7166734,2,1,6,6,0,0,0,0
7166784,1,1,7,7,0,3,3,3
7166784,2,1,8,7,1,1,2,2
7166940,1,1,0,0,0,0,0,0
7166940,2,1,0,0,0,0,0,0
7167047,1,1,0,0,0,0,0,0
7167047,2,1,4,3,1,0,1,1
7167047,3,1,8,6,2,0,2,2
7167047,4,1,8,6,2,0,2,2
7167056,1,1,5,5,0,0,0,0
7167056,2,1,13,17,-4,7,3,2
7167056,3,1,0,0,0,0,0,0
7167073,1,1,7,4,3,0,3,3
7167073,2,1,7,7,0,0,0,0
7167369,1,1,3,9,-6,7,1,0
7167369,2,1,0,0,0,0,0,0
7167399,1,1,2,2,0,0,0,0
7167399,2,1,17,19,-2,3,1,1
7167696,1,1,0,0,0,0,0,0
7167696,2,1,3,2,1,0,1,1
7167828,1,1,5,4,1,0,1,1
7167828,2,1,14,8,6,0,6,4
7168171,1,1,4,6,-2,3,1,1
7168171,2,1,4,4,0,0,0,0
7168171,3,1,10,9,1,0,1,1
7168201,1,1,2,2,0,0,0,0
7168201,2,1,0,0,0,0,0,0
7168253,1,1,3,2,1,0,1,1
7168253,2,1,2,2,0,0,0,0
7168253,3,1,0,0,0,0,0,0
7168253,5,1,2,4,-2,2,0,0
7168413,1,1,2,2,0,0,0,0
7168413,2,1,1,2,-1,1,0,0
7168634,1,1,10,6,4,0,4,1
7168634,2,1,3,6,-3,3,0,0
7168825,1,1,2,2,0,0,0,0
7168825,2,1,0,0,0,0,0,0
7168837,1,1,8,8,0,0,0,0
7168837,2,1,14,7,7,0,7,3
7168885,1,1,2,6,-4,4,0,0
7168885,2,1,6,5,1,0,1,1
7168885,3,1,6,5,1,2,3,1
7168918,1,1,17,16,1,0,1,1
7168918,2,1,5,4,1,0,1,1
7168930,1,1,9,8,1,0,1,0
7168930,2,1,1,3,-2,2,0,0
7169014,1,1,15,13,2,0,2,0
7169014,2,1,4,2,2,0,2,1
7169014,3,1,8,8,0,0,0,0
7169022,1,1,7,7,0,0,0,0
7169022,2,1,4,3,1,0,1,1
7169022,3,1,5,4,1,1,2,2
7169097,1,1,16,17,-1,2,1,1
7169097,2,1,7,9,-2,4,2,2
7169097,3,1,8,6,2,2,4,2
7169169,1,1,2,2,0,1,1,0
7169169,2,1,4,4,0,2,2,1
7169202,1,1,0,0,0,0,0,0
7169280,1,1,3,3,0,0,0,0
7169283,1,1,13,9,4,0,4,3
7169283,2,1,0,0,0,0,0,0
7169283,3,1,4,2,2,0,2,2
7169283,4,1,7,5,2,0,2,2
7169400,1,1,8,8,0,0,0,0
7169400,2,1,7,7,0,0,0,0
7169400,3,1,1,3,-2,2,0,0
7169467,1,1,2,2,0,0,0,0
7169467,2,1,3,2,1,0,1,1
7169467,3,1,0,0,0,0,0,0
7169557,1,1,4,2,2,0,2,2
7169557,2,1,5,2,3,0,3,3
7169594,1,1,3,3,0,0,0,0
7169594,2,1,6,6,0,0,0,0
7169686,2,1,5,2,3,0,3,3
7169768,1,1,9,9,0,0,0,0
7169768,2,1,8,9,-1,2,1,1
7169816,3,1,11,7,4,0,4,4
7169831,1,1,10,9,1,0,1,0
7169831,2,1,2,2,0,0,0,0
7169847,1,1,11,9,2,1,3,3
7169847,2,1,13,2,11,0,11,3
7169847,3,1,0,0,0,0,0,0
7169857,1,1,7,11,-4,4,0,0
7169857,2,1,2,2,0,0,0,0
7169857,3,1,0,0,0,0,0,0
7169958,1,1,3,4,-1,1,0,0
7169958,2,1,3,4,-1,1,0,0
7169975,1,1,0,0,0,0,0,0
7169975,2,1,0,0,0,0,0,0
7170059,1,1,3,9,-6,6,0,0
7170059,2,1,4,10,-6,7,1,1
7170338,1,1,0,0,0,0,0,0
7170338,2,1,0,0,0,0,0,0
7170338,3,1,0,0,0,0,0,0
7170513,2,1,5,10,-5,5,0,0
7170585,1,1,8,6,2,0,2,2
7170585,5,1,5,6,-1,2,1,1
7170665,1,1,0,0,0,0,0,0
7170665,2,1,6,7,-1,4,3,1
7170667,1,1,24,15,9,0,9,2
7170724,1,1,0,0,0,0,0,0
7170724,2,1,2,2,0,0,0,0
7170742,1,1,5,5,0,0,0,0
7170742,2,1,7,7,0,0,0,0
7170782,1,1,12,10,2,0,2,2
7170783,1,1,5,9,-4,4,0,0
7170783,2,1,0,0,0,0,0,0
7170790,1,1,2,5,-3,3,0,0
7170790,2,1,7,7,0,0,0,0
7170848,1,1,5,6,-1,3,2,2
7170848,2,1,3,3,0,0,0,0
7170848,3,1,0,0,0,0,0,0
7170872,2,1,18,13,5,0,5,5
7170902,1,1,10,9,1,0,1,1
7170902,2,1,6,6,0,0,0,0
7170935,2,1,3,5,-2,2,0,0
7170935,3,1,4,7,-3,4,1,1
7170955,1,1,0,0,0,0,0,0
7170955,3,1,4,2,2,0,2,2
7170955,5,1,0,0,0,0,0,0
7170972,1,1,3,2,1,0,1,1
7171084,1,1,5,4,1,0,1,1
7171105,1,1,10,9,1,1,2,2
7171105,3,1,4,6,-2,3,1,0
7171115,1,1,9,7,2,2,4,2
7171151,1,1,8,8,0,2,2,0
7171151,2,1,2,3,-1,1,0,0
7171151,3,1,11,8,3,1,4,2
7171171,1,1,2,4,-2,2,0,0
7171171,2,1,0,0,0,0,0,0
7171171,3,1,0,0,0,0,0,0
7171285,2,1,4,4,0,0,0,0
7171285,3,1,8,8,0,2,2,1
7171285,4,1,4,4,0,0,0,0
7171313,1,1,9,8,1,0,1,1
7171313,2,1,5,12,-7,7,0,0
7171313,3,1,3,8,-5,6,1,1
7171417,1,1,8,8,0,3,3,3
7171417,2,1,8,12,-4,7,3,3
7171720,1,1,3,5,-2,2,0,0
7171785,1,1,0,0,0,0,0,0
7171785,2,1,0,0,0,0,0,0
7171843,1,1,6,6,0,0,0,0
7171843,2,1,3,3,0,0,0,0
7172005,1,1,5,3,2,0,2,2
7172005,2,1,4,3,1,1,2,2
7172182,1,1,0,0,0,0,0,0
7172182,2,1,0,0,0,0,0,0
7172619,1,1,5,5,0,0,0,0
7172619,2,1,3,4,-1,1,0,0
7172669,1,1,8,7,1,0,1,1
7172669,2,1,3,4,-1,1,0,0
7172669,3,1,3,2,1,0,1,1
7172749,1,1,8,5,3,0,3,3
7172749,2,1,10,7,3,3,6,5
7172815,1,1,9,9,0,0,0,0
7172815,2,1,8,8,0,0,0,0
7172815,3,1,4,4,0,1,1,0
7172858,1,1,2,4,-2,2,0,0
7172858,2,1,8,8,0,0,0,0
7172939,1,1,3,2,1,0,1,0
7172939,2,1,11,10,1,0,1,1
7173128,1,1,1,3,-2,2,0,0
7173353,1,1,8,15,-7,7,0,0
7173609,1,1,2,2,0,0,0,0
7173614,1,1,2,3,-1,1,0,0
7173614,3,1,16,12,4,0,4,4
7173630,1,1,6,5,1,0,1,1
7173630,2,1,8,8,0,0,0,0
7173641,1,1,0,0,0,0,0,0
7173641,2,1,3,6,-3,3,0,0
7173661,2,1,1,5,-4,4,0,0
7173661,3,1,1,2,-1,1,0,0
7173692,1,1,9,5,4,0,4,3
7173692,2,1,4,4,0,1,1,1
7173697,1,1,9,7,2,0,2,1
7173697,2,1,0,0,0,0,0,0
7173816,1,1,0,0,0,0,0,0
7173816,2,1,0,0,0,0,0,0
7173816,3,1,0,0,0,0,0,0
7173816,4,1,0,0,0,0,0,0
7173816,5,1,0,0,0,0,0,0
7173942,1,1,3,3,0,2,2,0
7173942,2,1,7,6,1,0,1,1
7173942,3,1,4,6,-2,2,0,0
7174066,1,1,9,11,-2,2,0,0
7174066,2,1,10,6,4,0,4,0
7174066,3,1,2,2,0,0,0,0
7174066,4,1,1,2,-1,1,0,0
7174325,1,1,6,6,0,0,0,0
7174325,2,1,3,2,1,1,2,2
7174325,3,1,9,8,1,0,1,0
7174360,1,1,1,3,-2,2,0,0
7174360,2,1,10,4,6,0,6,6
7174520,1,1,6,5,1,2,3,2
7174520,2,1,5,3,2,0,2,2
7174586,1,1,15,5,10,0,10,0
7174586,2,1,2,2,0,0,0,0
7174586,3,1,8,3,5,0,5,0
7174619,1,1,2,2,0,0,0,0
7174619,2,1,5,4,1,0,1,1
7174619,3,1,0,0,0,0,0,0
7174619,4,1,3,2,1,0,1,1
7174634,1,1,4,4,0,0,0,0
7174634,2,1,3,2,1,0,1,1
7174634,3,1,4,3,1,0,1,1
7174634,4,1,16,8,8,0,8,2
7174634,5,1,13,2,11,0,11,3
7174667,1,1,3,3,0,0,0,0
7174667,2,1,3,3,0,0,0,0
7174667,3,1,3,3,0,0,0,0
7175017,1,1,4,4,0,0,0,0
7175017,2,1,7,4,3,0,3,2
7175017,4,1,4,8,-4,4,0,0
7175153,1,1,10,6,4,0,4,1
7175153,2,1,2,4,-2,3,1,1
7175185,1,1,0,0,0,0,0,0
7175185,2,1,0,0,0,0,0,0
7175193,1,1,10,11,-1,2,1,1
7175193,2,1,7,6,1,0,1,1
7175219,1,1,6,4,2,0,2,1
7175219,2,1,11,11,0,0,0,0
7175219,3,1,9,5,4,1,5,4
7176001,1,1,0,0,0,0,0,0
7176001,2,1,16,13,3,1,4,3
7176001,3,1,18,10,8,2,10,4
7176070,1,1,5,6,-1,1,0,0
7176180,1,1,9,12,-3,3,0,0
7176180,2,1,5,5,0,0,0,0
7176485,1,1,13,2,11,0,11,5
7176485,2,1,2,2,0,1,1,0
7176485,3,1,12,2,10,1,11,7
7176665,1,1,3,2,1,0,1,0
7176665,2,1,1,2,-1,1,0,0
7176665,3,1,5,2,3,0,3,2
7176724,1,1,8,8,0,0,0,0
7176751,1,1,0,0,0,0,0,0
7176751,2,1,0,0,0,0,0,0
7176763,1,1,4,2,2,0,2,1
7176763,2,1,8,8,0,0,0,0
7177539,1,1,22,7,15,0,15,13
7177612,1,1,5,5,0,0,0,0
7177639,1,1,5,7,-2,2,0,0
7177639,2,1,13,11,2,0,2,0
7177639,3,1,7,3,4,0,4,4
7177673,1,1,4,3,1,0,1,1
7177746,1,1,17,19,-2,3,1,1
7177787,1,1,4,6,-2,2,0,0
7177787,2,1,0,0,0,0,0,0
7177876,1,1,3,2,1,0,1,0
7177876,2,1,2,5,-3,3,0,0
7177920,1,1,4,6,-2,2,0,0
7177920,2,1,3,2,1,0,1,0
7177980,1,1,9,8,1,0,1,0
7177980,2,1,4,7,-3,3,0,0
7178056,1,1,9,9,0,0,0,0
7178122,1,1,10,12,-2,4,2,2
7178131,1,1,13,13,0,2,2,1
7178131,2,1,3,4,-1,1,0,0
7178171,1,1,4,6,-2,2,0,0
7178223,1,1,12,14,-2,2,0,0
7178328,1,1,5,8,-3,3,0,0
7178343,1,1,8,8,0,2,2,2
7178395,1,1,10,11,-1,2,1,1
7178395,2,1,12,9,3,0,3,3
7178406,1,1,4,5,-1,1,0,0
7178406,2,1,4,8,-4,4,0,0
7178415,1,1,8,8,0,0,0,0
7178415,2,1,13,12,1,2,3,3
7178422,1,1,8,7,1,0,1,1
7178422,2,1,2,2,0,0,0,0
7178422,3,1,7,7,0,0,0,0
7178497,1,1,7,6,1,0,1,1
7178497,3,1,2,6,-4,4,0,0
7178497,4,1,14,4,10,0,10,9
7178630,1,1,9,6,3,0,3,2
7178630,2,1,6,2,4,0,4,4
7178630,6,1,9,6,3,0,3,2
7178653,3,1,0,0,0,0,0,0
7178653,4,1,7,4,3,1,4,4
7178801,1,1,10,8,2,0,2,2
7178801,2,1,2,2,0,0,0,0
7178807,2,1,0,0,0,0,0,0
7178807,3,1,0,0,0,0,0,0
7178807,4,1,0,0,0,0,0,0
7178857,2,1,0,0,0,0,0,0
7178866,1,1,1,2,-1,1,0,0
7178895,1,1,5,8,-3,3,0,0
7178895,2,1,3,3,0,0,0,0
7178928,1,1,21,9,12,0,12,12
7178966,1,1,4,5,-1,2,1,1
7178966,2,1,9,10,-1,1,0,0
7178966,3,1,4,4,0,0,0,0
7178984,1,1,4,4,0,2,2,2
7178984,2,1,2,4,-2,2,0,0
7179019,1,1,2,2,0,0,0,0
7179019,2,1,4,6,-2,2,0,0
7179124,1,1,1,2,-1,1,0,0
7179124,2,1,3,2,1,0,1,1
7179124,3,1,5,3,2,1,3,3
7179124,4,1,5,4,1,0,1,1
7179124,5,1,0,0,0,0,0,0
7179128,1,1,5,5,0,0,0,0
7179168,1,1,6,14,-8,8,0,0
7179168,2,1,2,2,0,0,0,0
7179172,1,1,6,5,1,0,1,1
7179176,1,1,2,2,0,0,0,0
7179176,2,1,5,4,1,0,1,0
7179185,1,1,9,9,0,0,0,0
7179246,1,1,0,0,0,0,0,0
7179246,2,1,5,8,-3,3,0,0
7179288,1,1,7,8,-1,1,0,0
7179288,2,1,3,4,-1,1,0,0
7179304,1,1,17,16,1,0,1,1
7179304,2,1,3,5,-2,2,0,0
7179323,1,1,13,7,6,0,6,5
7179323,2,1,10,9,1,0,1,1
7179323,3,1,1,5,-4,4,0,0
7179323,4,1,1,5,-4,4,0,0
7179323,5,1,10,6,4,0,4,4
7179330,1,1,8,8,0,4,4,4
7179330,2,1,0,0,0,0,0,0
7179390,1,1,16,14,2,0,2,1
7179390,2,1,5,12,-7,7,0,0
7179405,1,1,4,9,-5,5,0,0
7179405,2,1,7,6,1,1,2,2
7179405,3,1,9,9,0,5,5,5
7179448,1,1,5,5,0,1,1,1
7179499,2,1,16,15,1,0,1,1
7179522,1,1,6,8,-2,4,2,2
7179522,3,1,3,6,-3,3,0,0
7179530,1,1,6,8,-2,2,0,0
7179530,2,1,6,8,-2,2,0,0
7179530,3,1,11,8,3,0,3,3
7179622,1,1,3,2,1,0,1,1
7179622,2,1,17,11,6,0,6,5
7179676,1,1,9,5,4,0,4,4
7179676,2,1,9,7,2,0,2,2
7179680,1,1,6,4,2,0,2,2
7179680,2,1,2,3,-1,2,1,0
7179680,3,1,5,4,1,0,1,1
7179718,1,1,0,0,0,0,0,0
7179743,1,1,0,0,0,0,0,0
7179743,2,1,0,0,0,0,0,0
7179906,1,1,6,6,0,0,0,0
7179906,2,1,2,2,0,0,0,0
7179965,1,1,5,8,-3,4,1,1
7179965,2,1,8,8,0,0,0,0
7179965,3,1,3,2,1,0,1,1
7179965,4,1,3,2,1,0,1,1
7180115,1,1,7,4,3,0,3,3
7180115,2,1,5,3,2,0,2,2
7180174,1,1,13,10,3,0,3,3
7180532,1,1,12,2,10,0,10,10
7180532,2,1,9,2,7,0,7,6
7180621,2,1,1,3,-2,2,0,0
7180621,3,1,3,2,1,0,1,1
7180621,4,1,4,6,-2,3,1,1
7180719,1,1,3,2,1,0,1,1
7180719,2,1,9,6,3,2,5,5
7180741,1,1,2,2,0,0,0,0
7180741,2,1,2,2,0,0,0,0
7180741,3,1,3,2,1,0,1,0
7180937,1,1,19,18,1,0,1,1
7180937,2,1,6,6,0,0,0,0
7180962,1,1,12,10,2,1,3,3
7180962,2,1,8,6,2,0,2,2
7180962,3,1,7,6,1,0,1,1
7181016,1,1,6,6,0,2,2,2
7181016,3,1,10,1,9,0,9,9
7181021,1,1,11,11,0,1,1,1
7181021,2,1,14,14,0,0,0,0
7181056,1,1,1,2,-1,1,0,0
7181056,2,1,2,6,-4,4,0,0
7181101,1,1,4,4,0,0,0,0
7181101,2,1,8,8,0,0,0,0
7181110,1,1,7,4,3,0,3,0
7181110,3,1,10,3,7,0,7,0
7181171,1,1,7,7,0,0,0,0
7181171,2,1,7,5,2,0,2,2
7181182,1,1,3,3,0,0,0,0
7181182,2,1,9,14,-5,6,1,1
7181195,1,1,4,4,0,0,0,0
7181195,2,1,11,11,0,0,0,0
7181195,3,1,12,10,2,1,3,3
7181406,1,1,5,6,-1,1,0,0
7181497,1,1,3,3,0,2,2,2
7181497,2,1,1,3,-2,2,0,0
7181656,1,1,3,3,0,0,0,0
7181656,2,1,4,4,0,0,0,0
7182018,1,1,0,0,0,0,0,0
7182018,3,1,1,2,-1,1,0,0
7182134,1,1,8,8,0,0,0,0
7182134,2,1,4,6,-2,3,1,1
7182141,1,1,0,0,0,0,0,0
7182141,3,1,0,0,0,0,0,0
7182437,1,1,2,2,0,0,0,0
7182437,2,1,2,2,0,0,0,0
7182631,1,1,3,2,1,0,1,1
7182631,2,1,11,2,9,0,9,9
7182668,1,1,10,8,2,0,2,2
7182688,1,1,0,0,0,0,0,0
7182719,1,1,2,2,0,0,0,0
7182719,4,1,8,7,1,0,1,1
7182760,3,1,3,2,1,1,2,1
7182990,1,1,0,0,0,0,0,0
7182990,2,1,0,0,0,0,0,0
7182990,3,1,0,0,0,0,0,0
7182990,4,1,0,0,0,0,0,0
7183113,1,1,10,10,0,0,0,0
7183113,2,1,6,6,0,0,0,0
7183154,1,1,6,6,0,0,0,0
7183154,2,1,7,7,0,0,0,0
7183291,1,1,6,4,2,0,2,2
7183291,2,1,2,4,-2,2,0,0
7183291,3,1,2,4,-2,2,0,0
7183353,1,1,0,0,0,0,0,0
7183353,2,1,0,0,0,0,0,0
7183353,3,1,0,0,0,0,0,0
7183388,1,1,2,2,0,1,1,0
7183388,3,1,15,2,13,0,13,12
7183391,1,1,3,7,-4,4,0,0
7183391,2,1,8,7,1,0,1,0
7183391,3,1,9,4,5,0,5,3
7183425,1,1,3,3,0,0,0,0
7183425,2,1,3,3,0,0,0,0
7183626,1,1,8,8,0,0,0,0
7183626,2,1,1,2,-1,1,0,0
7183626,3,1,0,0,0,0,0,0
7183626,4,1,2,2,0,0,0,0
7184134,1,1,2,5,-3,3,0,0
7184134,2,1,7,2,5,0,5,4
7184134,3,1,0,0,0,0,0,0
7184134,4,1,4,3,1,0,1,1
7184251,1,1,13,12,1,0,1,1
7184251,2,1,26,19,7,0,7,7
7184251,3,1,8,8,0,0,0,0
7184298,1,1,10,10,0,0,0,0
7184298,2,1,11,10,1,0,1,0
7184326,1,1,10,6,4,0,4,0
7184326,2,1,1,2,-1,1,0,0
7184326,3,1,10,5,5,1,6,2
7184326,4,1,10,3,7,0,7,0
7184369,1,1,4,3,1,0,1,1
7184369,2,1,5,3,2,0,2,2
7184375,1,1,0,0,0,0,0,0
7184375,2,1,0,0,0,0,0,0
7184375,3,1,7,2,5,0,5,5
7184482,1,1,6,7,-1,2,1,1
7184482,3,1,6,7,-1,2,1,1
7184482,4,1,5,5,0,1,1,1
7184562,1,1,6,6,0,0,0,0
7184562,2,1,5,4,1,0,1,0
7184563,1,1,0,0,0,0,0,0
7184563,2,1,0,0,0,0,0,0
7184563,3,1,0,0,0,0,0,0
7184662,1,1,7,7,0,0,0,0
7184662,2,1,7,7,0,0,0,0
7184662,3,1,2,2,0,0,0,0
7184662,4,1,2,4,-2,2,0,0
7184680,1,1,5,5,0,0,0,0
7184680,2,1,6,8,-2,3,1,1
7184733,1,1,7,6,1,2,3,2
7184806,1,1,2,2,0,0,0,0
7184806,2,1,16,15,1,0,1,1
7184867,1,1,7,7,0,0,0,0
7184867,2,1,1,7,-6,6,0,0
7184867,3,1,5,5,0,0,0,0
7184881,1,1,0,0,0,0,0,0
7184912,1,1,17,15,2,0,2,2
7184912,2,1,2,2,0,0,0,0
7184912,3,1,14,10,4,0,4,4
7184984,1,1,6,6,0,1,1,1
7184984,2,1,12,7,5,2,7,7
7185352,1,1,3,4,-1,2,1,1
7185352,2,1,4,4,0,0,0,0
7185352,3,1,3,4,-1,2,1,1
7185513,1,1,12,11,1,0,1,0
7185513,2,1,7,2,5,0,5,5
7185513,3,1,4,7,-3,3,0,0
7185575,1,1,7,6,1,0,1,1
7185575,2,1,7,7,0,0,0,0
7185575,3,1,16,3,13,0,13,9
7185575,4,1,7,8,-1,2,1,1
7185575,5,1,2,2,0,0,0,0
7185614,2,1,2,2,0,0,0,0
7185614,3,1,13,10,3,0,3,3
7185622,1,1,9,9,0,2,2,2
7185622,2,1,20,7,13,0,13,13
7185622,3,1,16,7,9,0,9,9
7185680,1,1,2,2,0,0,0,0
7185680,2,1,2,2,0,0,0,0
7185903,1,1,2,2,0,0,0,0
7185903,2,1,13,11,2,0,2,0
7185903,3,1,8,8,0,0,0,0
7185903,4,1,3,3,0,0,0,0
7185908,1,1,2,4,-2,2,0,0
7185908,3,1,2,4,-2,2,0,0
7185908,4,1,6,3,3,0,3,3
7186202,1,1,0,0,0,0,0,0
7186202,2,1,0,0,0,0,0,0
7186303,1,1,5,5,0,0,0,0
7186314,1,1,5,5,0,0,0,0
7186319,1,1,7,7,0,0,0,0
7186319,2,1,3,2,1,1,2,2
7186441,1,1,5,2,3,0,3,3
7186441,2,1,0,0,0,0,0,0
7186792,1,1,12,11,1,0,1,0
7186792,2,1,4,3,1,0,1,1
7186828,1,1,5,5,0,0,0,0
7186828,2,1,6,8,-2,2,0,0
7187026,1,1,0,0,0,0,0,0
7187026,2,1,4,2,2,0,2,2
7187026,3,1,6,4,2,2,4,4
7187026,4,1,9,9,0,4,4,4
7187045,3,1,13,4,9,0,9,9
7187462,1,1,5,5,0,0,0,0
7187462,2,1,7,13,-6,7,1,1
7187462,4,1,0,0,0,0,0,0
7187511,1,1,3,3,0,0,0,0
7187511,2,1,1,3,-2,2,0,0
7187517,3,1,0,0,0,0,0,0
7187629,1,1,8,6,2,0,2,1
7187629,2,1,6,3,3,0,3,3
7187756,1,1,3,6,-3,3,0,0
7187756,2,1,0,0,0,0,0,0
7187843,1,1,9,5,4,0,4,2
7187843,2,1,8,10,-2,4,2,2
7187850,1,1,3,4,-1,1,0,0
7187850,2,1,9,4,5,0,5,4
7187850,3,1,4,4,0,1,1,0
7188795,2,1,8,4,4,0,4,2
7189099,1,1,7,7,0,0,0,0
7189099,2,1,26,4,22,0,22,6
7189099,3,1,4,4,0,0,0,0
7189099,4,1,11,11,0,4,4,4
7189349,1,1,4,3,1,0,1,1
7189349,2,1,5,5,0,0,0,0
7189545,1,1,10,11,-1,1,0,0
7189545,2,1,8,11,-3,3,0,0
7189614,1,1,0,0,0,0,0,0
7189764,1,1,3,6,-3,3,0,0
7189764,2,1,1,2,-1,1,0,0
7189809,1,1,6,6,0,0,0,0
7189809,2,1,2,2,0,0,0,0
7189829,1,1,4,8,-4,4,0,0
7189845,1,1,11,5,6,3,9,9
7189866,1,1,2,4,-2,2,0,0
7189866,3,1,0,0,0,0,0,0
7189866,4,1,7,6,1,2,3,3
7189908,1,1,4,4,0,0,0,0
7189908,2,1,4,4,0,0,0,0
7189942,1,1,4,4,0,0,0,0
7189955,1,1,7,6,1,0,1,1
7189955,2,1,6,7,-1,3,2,2
7189956,1,1,4,8,-4,4,0,0
7190069,1,1,9,7,2,1,3,0
7190069,2,1,9,9,0,0,0,0
7190092,1,1,7,7,0,0,0,0
7190092,2,1,9,9,0,0,0,0
7190143,1,1,6,6,0,0,0,0
7190143,2,1,3,2,1,0,1,0
7190185,1,1,7,10,-3,3,0,0
7190185,2,1,5,6,-1,1,0,0
7190185,3,1,7,5,2,0,2,2
7190185,4,1,2,6,-4,4,0,0
7190234,1,1,14,10,4,0,4,3
7190234,2,1,5,4,1,0,1,1
7190252,1,1,7,7,0,0,0,0
7190252,2,1,5,12,-7,7,0,0
7190370,1,1,2,2,0,0,0,0
7190370,2,1,0,0,0,0,0,0
7190421,1,1,0,0,0,0,0,0
7190421,2,1,1,4,-3,3,0,0
7190428,1,1,9,7,2,0,2,0
7190428,2,1,9,7,2,0,2,2
7190428,3,1,9,6,3,0,3,2
7190468,1,1,4,3,1,0,1,1
7190468,2,1,6,5,1,1,2,2
7190560,1,1,6,6,0,0,0,0
7190560,2,1,10,8,2,0,2,2
7190560,3,1,2,2,0,1,1,0
7190685,1,1,7,10,-3,3,0,0
7190685,2,1,5,8,-3,3,0,0
7190958,1,1,3,3,0,0,0,0
7190958,2,1,7,4,3,0,3,2
7191159,1,1,5,9,-4,4,0,0
7191159,3,1,2,2,0,1,1,1
7191165,1,1,5,6,-1,1,0,0
7191165,2,1,2,2,0,1,1,1
7191165,3,1,6,9,-3,3,0,0
7191212,1,1,11,6,5,0,5,4
7191212,2,1,4,3,1,0,1,0
7191233,1,1,2,2,0,0,0,0
7191277,2,1,6,4,2,0,2,0
7191319,1,1,12,11,1,0,1,1
7191319,2,1,16,13,3,0,3,1
7191319,3,1,33,14,19,0,19,4
7191340,1,1,20,9,11,0,11,3
7191340,2,1,0,0,0,0,0,0
7191340,5,1,0,0,0,0,0,0
7191362,1,1,4,4,0,0,0,0
7191362,2,1,4,4,0,0,0,0
7191362,3,1,5,2,3,0,3,3
7191518,1,1,4,8,-4,5,1,0
7191526,1,1,10,5,5,0,5,2
7191633,1,1,8,8,0,0,0,0
7191633,2,1,5,8,-3,3,0,0
7191724,1,1,3,6,-3,3,0,0
7191724,2,1,5,4,1,0,1,1
7191987,1,1,1,3,-2,2,0,0
7191987,2,1,3,2,1,0,1,1
7191987,3,1,0,0,0,0,0,0
7192017,1,1,3,2,1,0,1,0
7192017,2,1,3,6,-3,3,0,0
7192053,1,1,5,5,0,1,1,0
7192079,1,1,4,4,0,0,0,0
7192079,2,1,0,0,0,0,0,0
7192079,3,1,5,5,0,0,0,0
7192159,1,1,0,0,0,0,0,0
7192159,2,1,10,4,6,0,6,2
7192226,1,1,3,9,-6,6,0,0
7192226,2,1,4,4,0,0,0,0
7192272,1,1,3,3,0,0,0,0
7192272,2,1,0,0,0,0,0,0
7192296,2,1,0,0,0,0,0,0
7192296,3,1,0,0,0,0,0,0
7192373,1,1,7,2,5,0,5,5
7192435,1,1,11,8,3,2,5,3
7192435,2,1,0,0,0,0,0,0
7192525,1,1,2,2,0,0,0,0
7192529,1,1,6,6,0,0,0,0
7192529,2,1,5,5,0,0,0,0
7192546,1,1,8,8,0,1,1,1
7192546,2,1,8,10,-2,3,1,0
7192552,1,1,5,3,2,0,2,1
7192644,1,1,6,6,0,0,0,0
7192644,2,1,4,4,0,0,0,0
7192710,1,1,2,4,-2,2,0,0
7192710,2,1,7,13,-6,6,0,0
7192710,3,1,8,2,6,0,6,6
7192740,1,1,10,8,2,0,2,2
7192740,2,1,3,2,1,0,1,1
7192746,1,1,6,11,-5,5,0,0
7192746,2,1,4,7,-3,5,2,0
7192803,1,1,3,3,0,0,0,0
7192803,2,1,6,5,1,0,1,1
7192803,3,1,5,4,1,1,2,2
7192803,4,1,3,3,0,0,0,0
7192807,1,1,4,4,0,0,0,0
7192807,2,1,8,7,1,0,1,0
7192817,2,1,19,17,2,0,2,2
7192817,3,1,18,18,0,0,0,0
7192817,4,1,4,3,1,0,1,1
7192818,1,1,2,2,0,0,0,0
7192818,2,1,3,3,0,0,0,0
7192829,1,1,4,4,0,0,0,0
7192829,2,1,2,2,0,0,0,0
7192873,1,1,3,4,-1,3,2,2
7192972,1,1,8,9,-1,3,2,0
7192972,2,1,2,2,0,0,0,0
7192972,3,1,1,3,-2,2,0,0
7193056,1,1,4,4,0,0,0,0
7193056,2,1,6,6,0,0,0,0
7193104,1,1,0,0,0,0,0,0
7193104,2,1,0,0,0,0,0,0
7193104,3,1,0,0,0,0,0,0
7193133,2,1,8,6,2,0,2,2
7193133,3,1,6,6,0,0,0,0
7193166,1,1,0,0,0,0,0,0
7193166,2,1,2,3,-1,1,0,0
7193178,1,1,6,2,4,0,4,4
7193178,2,1,7,2,5,0,5,5
7193192,1,1,9,4,5,0,5,3
7193239,1,1,7,6,1,1,2,2
7193239,2,1,0,0,0,0,0,0
7193341,1,1,11,4,7,0,7,7
7193341,2,1,7,3,4,1,5,5
7193388,1,1,2,2,0,1,1,1
7193564,1,1,2,3,-1,1,0,0
7193564,2,1,6,3,3,0,3,3
7193564,3,1,10,2,8,0,8,0
7193577,1,1,14,9,5,0,5,5
7193577,2,1,7,8,-1,1,0,0
7193590,1,1,8,6,2,0,2,2
7193590,2,1,14,8,6,0,6,6
7193590,3,1,0,0,0,0,0,0
7193639,1,1,14,15,-1,1,0,0
7193639,2,1,10,15,-5,5,0,0
7193639,3,1,6,5,1,0,1,0
7193910,1,1,2,4,-2,2,0,0
7193925,1,1,8,8,0,2,2,2
7193925,2,1,10,11,-1,2,1,0
7193971,1,1,4,2,2,0,2,2
7193971,2,1,2,2,0,0,0,0
7194193,1,1,3,3,0,0,0,0
7194193,2,1,4,4,0,0,0,0
7194320,1,1,9,5,4,2,6,6
7194320,5,1,2,2,0,0,0,0
7194320,6,1,11,2,9,0,9,2
7194421,1,1,5,6,-1,3,2,2
7194421,2,1,5,4,1,1,2,2
7194493,1,1,2,2,0,1,1,1
7194493,2,1,6,2,4,0,4,4
7194582,2,1,12,10,2,3,5,5
7194582,8,1,5,9,-4,4,0,0
7194787,1,1,5,4,1,0,1,0
7194787,2,1,5,5,0,0,0,0
7194787,3,1,5,2,3,1,4,0
7194787,4,1,1,2,-1,1,0,0
7194856,1,1,12,6,6,0,6,6
7194856,2,1,9,3,6,0,6,5
7194886,2,1,0,0,0,0,0,0
7194886,3,1,0,0,0,0,0,0
7195164,1,1,10,4,6,0,6,0
7195195,1,1,6,6,0,0,0,0
7195195,2,1,5,7,-2,2,0,0
7195368,1,1,2,10,-8,8,0,0
7195368,2,1,7,6,1,0,1,0
7195418,1,1,2,5,-3,3,0,0
7195418,2,1,10,9,1,0,1,0
7195418,3,1,4,4,0,0,0,0
7195441,1,1,4,6,-2,2,0,0
7195441,2,1,7,4,3,0,3,2
7195608,1,1,7,10,-3,4,1,1
7195608,2,1,5,3,2,1,3,2
7195679,1,1,0,0,0,0,0,0
7195828,1,1,0,0,0,0,0,0
7195828,2,1,0,0,0,0,0,0
7195867,3,1,7,6,1,0,1,1
7195972,1,1,3,3,0,0,0,0
7195972,2,1,8,6,2,0,2,1
7196031,1,1,0,0,0,0,0,0
7196031,2,1,7,10,-3,4,1,1
7196032,1,1,2,2,0,0,0,0
7196229,1,1,5,5,0,0,0,0
7196229,3,1,3,2,1,0,1,0
7196297,1,1,13,12,1,1,2,2
7196297,2,1,12,11,1,0,1,1
7196313,3,1,0,0,0,0,0,0
7196466,1,1,4,2,2,0,2,2
7196466,2,1,9,5,4,0,4,4
7196632,1,1,4,3,1,0,1,1
7196632,2,1,8,4,4,1,5,5
7196632,3,1,7,3,4,0,4,4
7196632,4,1,5,2,3,0,3,3
7196646,1,1,3,7,-4,5,1,1
7196646,2,1,8,9,-1,5,4,4
7196649,1,1,2,2,0,1,1,1
7196649,2,1,11,2,9,0,9,9
7196754,2,1,11,8,3,0,3,3
7196754,3,1,9,8,1,0,1,1
7196754,4,1,2,2,0,0,0,0
7196961,1,1,4,3,1,0,1,0
7197128,1,1,5,5,0,0,0,0
7197211,1,1,4,4,0,0,0,0
7197211,2,1,7,7,0,0,0,0
7197283,1,1,0,0,0,0,0,0
7197319,1,1,1,4,-3,3,0,0
7197758,1,1,4,3,1,0,1,1
7197758,2,1,1,2,-1,1,0,0
7197758,4,1,0,0,0,0,0,0
7197809,1,1,5,5,0,0,0,0
7197837,1,1,11,11,0,2,2,1
7198004,1,1,5,6,-1,1,0,0
7198004,2,1,7,6,1,1,2,2
7198017,1,1,11,4,7,0,7,5
7198017,2,1,0,0,0,0,0,0
7198859,1,1,15,14,1,0,1,1
7198916,1,1,4,4,0,0,0,0
7199227,1,1,11,9,2,0,2,2
7199353,1,1,7,7,0,0,0,0
7199393,1,1,10,9,1,0,1,0
7199393,2,1,5,5,0,0,0,0
7199444,1,1,8,7,1,0,1,1
7199452,1,1,5,2,3,0,3,3
7199487,1,1,2,6,-4,4,0,0
7199487,3,1,0,0,0,0,0,0
7199487,4,1,0,0,0,0,0,0
7199487,5,1,12,4,8,0,8,6
7199666,1,1,5,5,0,1,1,1
7199666,2,1,10,10,0,2,2,0
7199666,3,1,0,0,0,0,0,0
7199674,1,1,4,4,0,0,0,0
7199674,2,1,3,3,0,0,0,0
7199674,3,1,0,0,0,0,0,0
7199674,4,1,5,4,1,0,1,0
7199674,5,1,2,2,0,0,0,0
7199867,1,1,5,5,0,0,0,0
7199909,1,1,5,6,-1,1,0,0
7199909,2,1,3,3,0,0,0,0
7199932,1,1,6,6,0,0,0,0
7199932,2,1,12,11,1,0,1,0
7199963,1,1,2,2,0,0,0,0
7199963,2,1,2,2,0,0,0,0
7200003,1,1,6,3,3,0,3,3
7200003,2,1,3,2,1,0,1,1
7200037,1,1,5,8,-3,4,1,1
7200037,2,1,4,4,0,0,0,0
7200156,1,1,4,3,1,0,1,1
7200156,2,1,15,9,6,0,6,0
7200333,1,1,6,4,2,0,2,2
7200333,2,1,2,2,0,0,0,0
7200404,1,1,8,7,1,0,1,1
7200404,2,1,0,0,0,0,0,0
7200404,3,1,1,2,-1,1,0,0
7200404,4,1,7,5,2,0,2,2
7200423,1,1,4,4,0,0,0,0
7200423,2,1,0,0,0,0,0,0
7200621,1,1,6,5,1,0,1,1
7200639,1,1,10,8,2,0,2,2
7200639,2,1,10,8,2,0,2,2
7200670,1,1,4,5,-1,1,0,0
7200670,2,1,9,7,2,0,2,2
7200994,1,1,2,2,0,1,1,1
7200994,2,1,7,8,-1,1,0,0
7200994,3,1,12,4,8,1,9,8
7204117,1,1,8,2,6,0,6,5
7204117,2,1,0,0,0,0,0,0
7204620,1,1,7,8,-1,1,0,0
7204696,1,1,6,2,4,1,5,5
7204745,1,1,5,6,-1,1,0,0
7204745,2,1,14,12,2,0,2,2
7204792,1,1,7,6,1,0,1,1
7205120,1,1,9,7,2,1,3,2
7205120,2,1,1,2,-1,1,0,0
7205247,1,1,6,5,1,0,1,1
7205425,1,1,4,6,-2,2,0,0
7205425,2,1,7,6,1,0,1,1
7205504,1,1,10,8,2,0,2,2
7205504,2,1,0,0,0,0,0,0
7205671,1,1,6,6,0,0,0,0
7205671,2,1,9,9,0,0,0,0
7205698,2,1,0,0,0,0,0,0
7205698,3,1,0,0,0,0,0,0
7205850,1,1,3,0,3,0,3,0
7205850,2,1,18,10,8,0,8,8
7205905,1,1,5,5,0,0,0,0
7205905,2,1,9,6,3,1,4,4
7205958,1,1,7,6,1,0,1,1
7205958,2,1,7,5,2,0,2,2
7205958,3,1,5,7,-2,2,0,0
7205976,1,1,9,6,3,1,4,4
7206017,1,1,11,5,6,0,6,6
7206017,2,1,3,3,0,0,0,0
7206162,1,1,6,4,2,0,2,2
7206162,2,1,5,2,3,0,3,3
7206162,3,1,4,2,2,0,2,2
7206162,4,1,2,2,0,0,0,0
7206204,1,1,16,16,0,0,0,0
7206204,2,1,13,13,0,0,0,0
7206229,1,1,11,11,0,0,0,0
7206336,1,1,9,8,1,0,1,1
7206336,2,1,5,5,0,0,0,0
7206369,1,1,0,0,0,0,0,0
7206369,2,1,4,2,2,0,2,2
7206384,1,1,0,0,0,0,0,0
7206495,1,1,3,6,-3,3,0,0
7206495,2,1,7,8,-1,2,1,1
7206641,1,1,13,12,1,0,1,0
7206641,2,1,16,13,3,0,3,0
7206650,1,1,7,8,-1,1,0,0
7206650,2,1,10,7,3,0,3,3
7206650,3,1,8,7,1,0,1,1
7206773,1,1,6,7,-1,2,1,1
7206834,1,1,11,11,0,0,0,0
7206834,2,1,3,11,-8,9,1,1
7206974,1,1,5,5,0,0,0,0
7206974,2,1,8,5,3,0,3,3
7207127,1,1,4,4,0,0,0,0
7207237,1,1,6,10,-4,6,2,2
7207237,2,1,6,3,3,0,3,2
7207254,1,1,4,4,0,0,0,0
7207254,2,1,4,4,0,0,0,0
7207462,1,1,17,7,10,0,10,10
7207533,1,1,3,3,0,0,0,0
7207533,2,1,3,2,1,0,1,1
7207615,1,1,4,2,2,0,2,0
7207615,2,1,2,2,0,0,0,0
7207615,3,1,9,8,1,0,1,1
7207615,4,1,0,0,0,0,0,0
7207615,5,1,6,2,4,0,4,4
7207615,6,1,16,10,6,0,6,3
7207670,1,1,3,3,0,0,0,0
7207760,1,1,5,5,0,0,0,0
7207760,2,1,2,2,0,0,0,0
7207774,1,1,3,2,1,0,1,0
7207774,2,1,9,7,2,0,2,2
7207897,1,1,6,6,0,1,1,1
7207925,1,1,8,10,-2,2,0,0
7207925,2,1,10,10,0,0,0,0
7207934,1,1,0,0,0,0,0,0
7207940,1,1,2,2,0,0,0,0
7207940,3,1,3,3,0,0,0,0
7208114,1,1,3,2,1,0,1,1
7208114,2,1,3,5,-2,2,0,0
7208372,1,1,10,9,1,0,1,1
7208372,2,1,8,6,2,0,2,0
7208372,4,1,5,2,3,0,3,3
7208527,1,1,2,2,0,0,0,0
7208527,2,1,6,2,4,0,4,4
7208633,1,1,11,11,0,0,0,0
7208633,2,1,6,6,0,0,0,0
7208654,1,1,8,7,1,0,1,1
7208682,1,1,3,6,-3,3,0,0
7208706,1,1,5,7,-2,2,0,0
7208706,2,1,0,0,0,0,0,0
7208757,1,1,3,8,-5,5,0,0
7208757,2,1,7,6,1,0,1,0
7208830,1,1,10,9,1,2,3,3
7208830,2,1,8,6,2,0,2,2
7210241,1,1,0,0,0,0,0,0
7210241,2,1,2,2,0,0,0,0
7210303,1,1,4,4,0,0,0,0
7210303,2,1,7,6,1,1,2,2
7210303,3,1,3,2,1,0,1,1
7210317,2,1,6,4,2,2,4,4
7210317,3,1,2,6,-4,4,0,0
7210481,1,1,12,12,0,0,0,0
7210481,2,1,18,18,0,0,0,0
7210493,1,1,4,6,-2,2,0,0
7210493,2,1,11,5,6,0,6,5
7210833,1,1,4,4,0,0,0,0
7210833,2,1,2,4,-2,2,0,0
7210833,3,1,8,5,3,0,3,3
7210856,1,1,5,5,0,0,0,0
7210856,2,1,11,12,-1,1,0,0
7210943,1,1,18,13,5,1,6,6
7210943,3,1,7,4,3,0,3,3
7210995,1,1,10,6,4,0,4,1
7210995,2,1,2,2,0,0,0,0
7210995,3,1,0,0,0,0,0,0
7211076,1,1,5,2,3,0,3,3
7211076,2,1,5,2,3,1,4,0
7211087,1,1,5,2,3,0,3,0
7211087,2,1,8,8,0,0,0,0
7211308,1,1,5,3,2,0,2,2
7211308,2,1,10,9,1,0,1,0
7211308,3,1,0,0,0,0,0,0
7211426,1,1,2,2,0,0,0,0
7211426,2,1,2,2,0,0,0,0
7211505,1,1,4,5,-1,1,0,0
7211505,2,1,2,2,0,0,0,0
7211505,3,1,5,5,0,0,0,0
7211523,1,1,3,5,-2,4,2,2
7211523,3,1,0,0,0,0,0,0
7211560,1,1,12,9,3,0,3,3
7211560,2,1,13,10,3,0,3,3
