sampno,perno,diarytripsday1,gpstripsday1,gpstripsday2,gpstripsday3,totalgpstrips,geom
1041494,1,0,0,0,0,0,REDACTED
1041494,2,0,0,1,0,1,REDACTED
1041494,3,0,0,4,0,4,REDACTED
1041494,4,2,0,2,0,2,REDACTED
1043613,1,6,6,1,9,16,REDACTED
1043613,2,5,6,1,5,12,REDACTED
1048852,1,18,16,7,13,36,REDACTED
1050385,1,4,3,5,10,18,REDACTED
1050385,2,0,12,5,5,22,REDACTED
1052905,1,9,9,3,1,13,REDACTED
1055449,1,2,5,14,0,19,REDACTED
1055449,2,4,7,4,3,14,REDACTED
1059276,1,9,16,8,10,34,REDACTED
1065589,1,2,3,1,3,7,REDACTED
1065589,2,2,2,4,3,9,REDACTED
1066541,1,5,5,0,0,5,REDACTED
1066541,2,4,8,0,0,8,REDACTED
1119021,1,0,0,3,4,7,REDACTED
1119021,2,0,0,2,4,6,REDACTED
1119035,1,4,6,4,3,13,REDACTED
1119040,1,2,2,4,1,7,REDACTED
1119762,1,5,6,0,0,6,REDACTED
1119993,1,11,12,5,10,27,REDACTED
1119993,2,9,11,5,5,21,REDACTED
1120119,1,6,6,5,9,20,REDACTED
1120231,1,4,5,2,0,7,REDACTED
1120697,1,9,11,4,10,25,REDACTED
1120697,2,0,0,0,0,0,REDACTED
1121125,1,8,8,0,4,12,REDACTED
1121261,1,7,9,5,6,20,REDACTED
1121261,2,3,3,5,5,13,REDACTED
1121263,1,9,10,12,3,25,REDACTED
1121263,2,4,6,6,2,14,REDACTED
1121310,1,5,2,0,0,2,REDACTED
1121310,2,5,5,5,7,17,REDACTED
1121448,1,2,2,5,2,9,REDACTED
1121448,2,5,5,3,5,13,REDACTED
1121448,3,4,3,6,2,11,REDACTED
1121606,1,12,13,7,6,26,REDACTED
1121606,2,6,6,2,6,14,REDACTED
1121694,1,2,6,17,9,32,REDACTED
1121694,2,2,2,11,9,22,REDACTED
1121752,1,7,8,1,0,9,REDACTED
1121752,2,8,15,7,15,37,REDACTED
1123124,1,5,11,11,17,39,REDACTED
1123124,2,3,0,0,0,0,REDACTED
1123124,3,7,18,8,0,26,REDACTED
1123124,4,0,0,0,0,0,REDACTED
1123197,1,6,5,12,16,33,REDACTED
1123197,2,0,10,10,2,22,REDACTED
1123197,3,3,3,0,2,5,REDACTED
1123197,4,3,6,10,2,18,REDACTED
1123587,1,8,5,3,0,8,REDACTED
1123587,2,9,9,4,1,14,REDACTED
1123731,1,5,5,8,12,25,REDACTED
1123731,2,6,0,0,0,0,REDACTED
1123731,3,8,8,0,0,8,REDACTED
1123731,4,5,7,6,7,20,REDACTED
1124202,1,10,12,0,0,12,REDACTED
1124202,2,10,9,0,0,9,REDACTED
1124202,3,8,1,0,0,1,REDACTED
1124315,1,4,4,0,3,7,REDACTED
1124362,1,0,0,0,0,0,REDACTED
1124474,1,3,3,0,0,3,REDACTED
1124474,2,6,5,1,0,6,REDACTED
1124769,1,9,12,14,11,37,REDACTED
1124769,2,0,0,0,0,0,REDACTED
1124769,3,6,10,9,8,27,REDACTED
1125257,2,6,13,11,4,28,REDACTED
1125309,1,2,5,3,16,24,REDACTED
1125309,2,2,35,37,12,84,REDACTED
1125309,3,8,11,13,15,39,REDACTED
1125492,1,5,6,4,11,21,REDACTED
1125492,2,5,2,3,11,16,REDACTED
1125492,3,5,10,2,2,14,REDACTED
1125843,1,4,2,0,5,7,REDACTED
1125843,2,5,4,9,7,20,REDACTED
1125937,1,2,2,8,10,20,REDACTED
1125937,2,2,3,20,6,29,REDACTED
1125964,1,3,4,3,3,10,REDACTED
1126014,1,3,3,9,0,12,REDACTED
1126396,1,0,0,11,10,21,REDACTED
1126853,1,10,10,1,11,22,REDACTED
1126853,2,8,9,1,5,15,REDACTED
1126968,1,0,1,7,6,14,REDACTED
1126968,2,0,0,0,0,0,REDACTED
1126992,1,9,9,6,1,16,REDACTED
1127272,1,2,6,6,5,17,REDACTED
2630646,2,2,3,2,3,8,REDACTED
1127272,2,5,9,11,0,20,REDACTED
1127481,1,5,5,1,0,6,REDACTED
1127481,2,6,19,20,20,59,REDACTED
1127626,1,11,13,17,21,51,REDACTED
1127626,2,13,13,11,13,37,REDACTED
1127843,1,4,4,3,13,20,REDACTED
1127843,2,3,5,6,2,13,REDACTED
1128205,1,6,3,2,4,9,REDACTED
1128205,2,5,7,5,0,12,REDACTED
1128205,3,2,3,5,0,8,REDACTED
1128394,1,9,7,12,0,19,REDACTED
1129139,1,5,6,0,2,8,REDACTED
1129697,1,0,0,7,10,17,REDACTED
1129862,1,3,9,15,5,29,REDACTED
1129862,2,3,5,17,6,28,REDACTED
1129862,3,0,2,0,0,2,REDACTED
1129862,4,0,0,0,0,0,REDACTED
1129862,5,6,3,5,0,8,REDACTED
1130076,1,8,9,8,4,21,REDACTED
1130076,2,3,4,5,2,11,REDACTED
1130977,1,6,7,7,0,14,REDACTED
1131308,1,2,3,0,2,5,REDACTED
1131308,2,3,0,6,6,12,REDACTED
1131308,3,2,4,0,2,6,REDACTED
1131308,4,2,0,0,0,0,REDACTED
1131380,1,9,9,10,9,28,REDACTED
1131380,2,5,1,2,3,6,REDACTED
1131380,3,0,0,0,11,11,REDACTED
1131529,1,10,12,0,8,20,REDACTED
1131529,2,9,10,8,3,21,REDACTED
1131529,3,5,12,10,0,22,REDACTED
1131592,1,0,0,0,0,0,REDACTED
1132119,1,8,7,0,0,7,REDACTED
1132139,1,9,9,10,11,30,REDACTED
1132139,2,4,3,4,6,13,REDACTED
1132210,1,5,4,2,0,6,REDACTED
1132210,2,0,0,0,4,4,REDACTED
1132468,1,7,9,8,4,21,REDACTED
1132468,2,2,21,9,10,40,REDACTED
1132741,1,6,6,8,10,24,REDACTED
1132741,2,4,2,9,6,17,REDACTED
1132759,1,6,9,2,2,13,REDACTED
1132759,2,3,5,16,2,23,REDACTED
1132890,1,6,3,10,7,20,REDACTED
1132890,2,7,5,13,10,28,REDACTED
1133036,1,5,6,1,4,11,REDACTED
1133036,2,12,8,0,2,10,REDACTED
1133154,1,4,2,7,4,13,REDACTED
1133154,2,0,0,3,0,3,REDACTED
1133154,3,6,2,10,3,15,REDACTED
1133154,4,2,0,1,0,1,REDACTED
1133746,1,0,0,9,7,16,REDACTED
1133746,2,2,5,0,0,5,REDACTED
1133746,3,0,0,0,18,18,REDACTED
1133746,4,0,0,4,0,4,REDACTED
1133746,5,1,3,16,6,25,REDACTED
1134113,1,2,2,2,0,4,REDACTED
1134113,2,2,1,8,14,23,REDACTED
1134135,1,2,3,2,4,9,REDACTED
1134135,2,6,7,5,4,16,REDACTED
1134394,1,0,0,0,0,0,REDACTED
2658696,2,0,5,0,9,14,REDACTED
1134860,1,0,0,0,0,0,REDACTED
1134890,1,3,7,6,0,13,REDACTED
1134890,2,3,7,0,9,16,REDACTED
1134890,3,3,8,0,2,10,REDACTED
1134890,4,3,8,5,2,15,REDACTED
1134890,5,2,2,0,9,11,REDACTED
1134890,6,4,2,7,9,18,REDACTED
1134890,7,3,0,7,10,17,REDACTED
1135117,1,4,4,5,0,9,REDACTED
1135117,2,2,4,0,10,14,REDACTED
1135291,1,3,4,4,6,14,REDACTED
1135291,2,3,4,8,9,21,REDACTED
1135478,1,4,6,9,5,20,REDACTED
1135478,2,0,2,1,5,8,REDACTED
1135630,1,6,5,0,0,5,REDACTED
1135876,1,2,2,7,8,17,REDACTED
1135876,2,0,0,0,0,0,REDACTED
1135876,3,3,0,0,0,0,REDACTED
1135906,1,11,1,5,7,13,REDACTED
1135906,2,3,5,10,1,16,REDACTED
1135920,1,0,0,0,0,0,REDACTED
1135920,2,2,2,0,0,2,REDACTED
1135976,1,5,4,0,7,11,REDACTED
1135976,2,2,4,3,0,7,REDACTED
1136102,1,8,8,0,0,8,REDACTED
1136119,1,0,0,0,0,0,REDACTED
1136119,2,4,4,0,0,4,REDACTED
1136119,3,2,5,0,0,5,REDACTED
1136370,1,9,16,4,4,24,REDACTED
1136370,2,7,9,2,5,16,REDACTED
1136407,1,0,0,0,0,0,REDACTED
1136407,2,4,3,8,2,13,REDACTED
1136853,1,0,0,0,0,0,REDACTED
1136853,2,0,0,9,0,9,REDACTED
1136989,1,7,9,7,9,25,REDACTED
1136989,2,7,7,3,6,16,REDACTED
1137373,1,1,1,6,1,8,REDACTED
1137373,2,2,6,3,2,11,REDACTED
1137381,1,0,0,0,3,3,REDACTED
1137381,2,6,8,3,0,11,REDACTED
1137895,1,5,6,8,6,20,REDACTED
1137895,2,6,3,2,0,5,REDACTED
1137895,3,2,3,0,2,5,REDACTED
1138127,1,4,7,6,8,21,REDACTED
1138323,1,2,4,11,0,15,REDACTED
1138323,2,6,5,2,4,11,REDACTED
1138391,1,1,5,4,0,9,REDACTED
1138391,2,0,0,0,0,0,REDACTED
1138686,1,8,9,4,11,24,REDACTED
1138707,1,9,10,9,12,31,REDACTED
1138707,2,4,4,5,8,17,REDACTED
1138707,3,2,3,1,2,6,REDACTED
1138798,1,3,5,0,0,5,REDACTED
1138798,2,0,0,5,2,7,REDACTED
1139208,1,4,4,5,3,12,REDACTED
1139254,1,0,0,0,0,0,REDACTED
1139254,2,0,0,0,0,0,REDACTED
1139514,1,8,12,12,6,30,REDACTED
1139514,2,4,3,0,2,5,REDACTED
1139845,1,3,3,13,10,26,REDACTED
1139845,2,2,4,1,0,5,REDACTED
1139913,1,3,3,0,0,3,REDACTED
1140147,1,5,8,8,0,16,REDACTED
1140200,1,11,5,4,0,9,REDACTED
1140227,1,3,16,15,16,47,REDACTED
1140514,1,8,10,11,1,22,REDACTED
1140514,2,6,4,7,0,11,REDACTED
1140730,1,2,0,6,13,19,REDACTED
1140730,2,5,9,5,4,18,REDACTED
1140730,3,3,5,0,8,13,REDACTED
1140730,4,2,3,11,1,15,REDACTED
1140730,5,6,12,3,14,29,REDACTED
1140949,1,3,2,0,13,15,REDACTED
1141077,1,0,0,0,24,24,REDACTED
1141077,2,0,0,0,26,26,REDACTED
1141185,1,7,14,11,10,35,REDACTED
1141185,2,4,11,18,0,29,REDACTED
1141648,1,3,3,9,3,15,REDACTED
1141648,2,0,0,0,0,0,REDACTED
1141686,1,7,9,12,20,41,REDACTED
1141686,2,2,2,6,3,11,REDACTED
1142029,1,4,4,4,2,10,REDACTED
1142029,2,4,1,4,4,9,REDACTED
1142612,1,4,5,0,3,8,REDACTED
1142612,2,4,5,0,0,5,REDACTED
1142701,1,5,5,3,4,12,REDACTED
1142701,2,7,5,4,1,10,REDACTED
1142701,3,7,8,5,0,13,REDACTED
1142789,1,7,5,8,11,24,REDACTED
1143233,1,5,4,2,2,8,REDACTED
1143233,2,4,4,4,10,18,REDACTED
1143505,1,6,6,5,1,12,REDACTED
1143505,2,9,10,9,5,24,REDACTED
1143740,1,6,6,6,6,18,REDACTED
1143814,1,0,0,0,7,7,REDACTED
1143814,2,0,0,0,7,7,REDACTED
1145194,1,6,4,0,1,5,REDACTED
1145194,2,8,5,0,4,9,REDACTED
1145353,1,6,2,5,2,9,REDACTED
1145588,1,3,2,0,1,3,REDACTED
1145588,2,5,5,5,10,20,REDACTED
1147026,1,1,6,1,1,8,REDACTED
1147026,2,2,4,0,0,4,REDACTED
1147026,3,0,0,0,0,0,REDACTED
1147026,4,8,0,0,0,0,REDACTED
1147026,7,0,0,0,0,0,REDACTED
1147833,1,13,5,0,0,5,REDACTED
1147833,2,10,14,0,0,14,REDACTED
1148086,1,4,6,7,12,25,REDACTED
1148453,1,10,11,6,2,19,REDACTED
1148899,1,8,12,5,11,28,REDACTED
1148899,2,0,0,1,0,1,REDACTED
1148962,1,0,0,0,0,0,REDACTED
1149029,1,7,2,5,0,7,REDACTED
1149029,2,8,8,6,0,14,REDACTED
1149029,3,0,0,0,0,0,REDACTED
1149981,1,5,5,0,0,5,REDACTED
1149981,2,12,13,0,0,13,REDACTED
1150090,1,9,10,6,2,18,REDACTED
1150090,2,12,16,8,0,24,REDACTED
1150277,1,5,13,14,6,33,REDACTED
1150298,1,8,9,0,7,16,REDACTED
1150298,2,16,24,8,7,39,REDACTED
1150298,3,2,9,7,0,16,REDACTED
1150298,4,14,18,10,10,38,REDACTED
1150646,1,4,4,7,2,13,REDACTED
1150835,1,9,7,0,0,7,REDACTED
1151272,1,3,0,5,13,18,REDACTED
1151272,2,2,2,6,9,17,REDACTED
1151272,3,2,4,0,9,13,REDACTED
1151647,1,2,2,5,6,13,REDACTED
1151647,2,6,6,0,0,6,REDACTED
1152715,1,0,0,1,0,1,REDACTED
1152715,2,0,0,0,0,0,REDACTED
1152715,3,0,0,0,0,0,REDACTED
1152854,1,6,6,2,0,8,REDACTED
1152854,2,7,4,9,0,13,REDACTED
1153183,1,2,2,3,5,10,REDACTED
1153183,2,2,6,6,7,19,REDACTED
1153453,1,7,7,12,0,19,REDACTED
1153453,2,8,12,9,0,21,REDACTED
1153616,1,4,6,0,0,6,REDACTED
1153616,2,10,12,0,0,12,REDACTED
1153616,3,0,0,0,0,0,REDACTED
1153616,4,8,10,0,0,10,REDACTED
1154699,1,0,0,0,0,0,REDACTED
1155258,1,6,6,3,14,23,REDACTED
1155258,2,3,4,9,3,16,REDACTED
1155425,1,7,7,7,1,15,REDACTED
1155425,2,4,5,8,10,23,REDACTED
1155425,3,2,2,9,10,21,REDACTED
1155425,4,5,0,0,0,0,REDACTED
1155767,1,2,2,9,2,13,REDACTED
1155767,2,10,10,11,15,36,REDACTED
1156030,1,0,0,13,0,13,REDACTED
1156030,2,0,0,14,0,14,REDACTED
1156555,1,2,2,7,3,12,REDACTED
1156555,2,4,5,9,7,21,REDACTED
1157090,1,7,9,14,10,33,REDACTED
1157763,1,4,5,8,5,18,REDACTED
1158177,1,0,0,0,0,0,REDACTED
1158177,2,0,0,0,0,0,REDACTED
1158177,3,0,0,0,0,0,REDACTED
1158255,1,6,6,9,2,17,REDACTED
1158255,2,6,4,12,5,21,REDACTED
1158841,1,5,4,3,4,11,REDACTED
1158841,2,6,8,0,2,10,REDACTED
1159400,1,4,6,0,0,6,REDACTED
1160166,1,4,4,25,6,35,REDACTED
1160166,2,2,4,5,5,14,REDACTED
1160166,3,0,0,4,4,8,REDACTED
1160182,1,0,0,0,0,0,REDACTED
1160240,1,8,8,0,0,8,REDACTED
1160240,2,9,9,4,3,16,REDACTED
1160945,1,5,5,8,3,16,REDACTED
1160945,2,5,4,7,3,14,REDACTED
1161045,1,7,6,2,13,21,REDACTED
1161045,2,7,5,7,12,24,REDACTED
1161045,3,0,0,4,13,17,REDACTED
1161710,1,0,0,4,4,8,REDACTED
1161987,1,9,7,6,9,22,REDACTED
1161987,2,10,16,9,19,44,REDACTED
1162368,1,5,5,9,6,20,REDACTED
1162368,2,3,3,6,2,11,REDACTED
1162368,3,2,5,5,9,19,REDACTED
1162672,1,0,0,0,0,0,REDACTED
1162672,2,0,0,0,0,0,REDACTED
1162704,1,6,1,4,2,7,REDACTED
1162704,2,2,5,2,4,11,REDACTED
1162757,1,12,13,4,11,28,REDACTED
1162757,2,12,12,8,2,22,REDACTED
1162978,1,10,13,19,16,48,REDACTED
1163204,1,5,5,6,5,16,REDACTED
1163726,1,6,6,0,0,6,REDACTED
1163961,1,4,4,7,3,14,REDACTED
1163961,2,7,8,7,6,21,REDACTED
1164027,1,3,3,3,3,9,REDACTED
1164027,2,0,0,0,0,0,REDACTED
1164052,1,14,15,9,9,33,REDACTED
1164052,2,7,6,7,4,17,REDACTED
1164304,1,2,4,1,0,5,REDACTED
1164304,2,10,14,11,14,39,REDACTED
1164369,1,12,14,14,0,28,REDACTED
1164665,1,7,21,24,16,61,REDACTED
1165464,1,9,4,8,2,14,REDACTED
1166148,1,2,6,10,4,20,REDACTED
1166148,2,0,4,10,8,22,REDACTED
1166231,1,2,4,2,0,6,REDACTED
1166231,2,3,8,10,0,18,REDACTED
1166231,3,3,9,9,4,22,REDACTED
1166231,4,0,4,15,0,19,REDACTED
1166359,1,3,4,9,2,15,REDACTED
1166359,2,2,2,0,0,2,REDACTED
1166704,1,9,9,10,5,24,REDACTED
1167406,1,9,12,3,3,18,REDACTED
1168201,1,0,0,10,0,10,REDACTED
1168201,2,2,2,2,0,4,REDACTED
1168555,1,0,0,0,0,0,REDACTED
1168673,1,4,8,0,0,8,REDACTED
1168906,1,9,5,11,5,21,REDACTED
1168906,2,2,2,0,3,5,REDACTED
1168906,3,4,4,3,3,10,REDACTED
1169219,1,8,6,7,18,31,REDACTED
1169372,1,2,2,9,0,11,REDACTED
1169372,2,2,4,3,4,11,REDACTED
1169868,1,4,4,12,0,16,REDACTED
1169868,2,7,7,10,5,22,REDACTED
1169868,3,11,23,0,0,23,REDACTED
1170324,1,9,10,3,10,23,REDACTED
1170324,2,3,4,0,0,4,REDACTED
1170324,3,3,10,5,5,20,REDACTED
1170470,1,8,8,7,9,24,REDACTED
1170713,1,3,2,3,3,8,REDACTED
1170713,2,2,5,4,0,9,REDACTED
1170713,3,3,7,9,7,23,REDACTED
1170729,1,4,3,4,2,9,REDACTED
1171106,1,0,0,0,0,0,REDACTED
1172202,1,4,4,7,0,11,REDACTED
1172202,2,12,4,11,1,16,REDACTED
1172515,1,5,5,8,2,15,REDACTED
1172515,2,10,5,6,4,15,REDACTED
1172515,3,2,0,0,0,0,REDACTED
1172515,4,5,13,4,6,23,REDACTED
1172515,5,9,10,2,0,12,REDACTED
1172515,6,6,13,0,16,29,REDACTED
1172549,1,6,9,13,12,34,REDACTED
1172549,2,7,7,6,6,19,REDACTED
1172549,3,0,0,4,13,17,REDACTED
1172549,4,6,7,2,5,14,REDACTED
1172549,5,7,2,6,6,14,REDACTED
1172716,1,0,0,2,0,2,REDACTED
1172814,1,6,4,0,0,4,REDACTED
1172814,2,7,9,0,0,9,REDACTED
1172814,3,6,6,0,0,6,REDACTED
1172814,4,6,6,0,0,6,REDACTED
1172894,1,5,5,5,0,10,REDACTED
1172894,2,5,5,5,0,10,REDACTED
1172957,1,7,7,5,11,23,REDACTED
1172957,2,6,3,5,6,14,REDACTED
1173157,1,6,8,12,3,23,REDACTED
1173157,2,4,5,4,2,11,REDACTED
1173654,1,9,7,13,17,37,REDACTED
1173654,2,7,4,7,14,25,REDACTED
1173669,1,2,2,1,2,5,REDACTED
1173669,2,2,3,4,0,7,REDACTED
1173939,1,8,9,0,0,9,REDACTED
1174276,1,7,7,4,4,15,REDACTED
1176798,1,6,7,0,0,7,REDACTED
1176798,2,4,4,0,0,4,REDACTED
1176804,1,6,6,11,0,17,REDACTED
1176804,2,4,4,0,0,4,REDACTED
1177174,1,4,4,6,2,12,REDACTED
1177174,2,0,0,0,0,0,REDACTED
1177229,1,6,6,0,6,12,REDACTED
1177229,2,5,4,2,0,6,REDACTED
1177333,1,2,6,6,6,18,REDACTED
1177333,2,0,0,0,9,9,REDACTED
1178677,1,6,4,2,11,17,REDACTED
1178677,2,8,5,0,9,14,REDACTED
1179431,1,2,2,4,3,9,REDACTED
1179431,2,0,0,0,0,0,REDACTED
1179438,1,3,3,3,9,15,REDACTED
1179438,2,6,6,4,4,14,REDACTED
1179615,1,8,4,3,6,13,REDACTED
1179615,2,7,8,13,0,21,REDACTED
1180223,1,9,7,0,0,7,REDACTED
1180223,2,5,3,0,0,3,REDACTED
1180223,3,2,2,0,0,2,REDACTED
1180392,1,13,11,4,3,18,REDACTED
1180392,2,11,11,5,8,24,REDACTED
1182950,1,6,1,0,0,1,REDACTED
1183122,1,0,0,0,0,0,REDACTED
1183122,2,0,0,0,0,0,REDACTED
1183722,1,8,9,6,9,24,REDACTED
1183722,2,12,12,8,12,32,REDACTED
1185125,1,0,0,4,7,11,REDACTED
1185125,2,2,2,4,6,12,REDACTED
1185196,1,7,7,5,7,19,REDACTED
1185393,1,5,7,8,6,21,REDACTED
1185817,1,4,6,5,4,15,REDACTED
1185817,2,8,5,3,7,15,REDACTED
1186189,1,5,6,7,0,13,REDACTED
1186189,2,4,5,0,0,5,REDACTED
1186575,1,5,5,6,6,17,REDACTED
1186575,2,2,2,3,2,7,REDACTED
1187427,1,14,8,9,10,27,REDACTED
1187427,4,11,7,12,9,28,REDACTED
1188614,1,5,10,9,16,35,REDACTED
1188614,2,6,16,6,6,28,REDACTED
1188930,1,2,4,3,8,15,REDACTED
1189565,1,6,6,4,5,15,REDACTED
1189565,2,3,3,0,0,3,REDACTED
1191381,1,5,7,0,6,13,REDACTED
1191381,2,33,18,21,12,51,REDACTED
1197357,1,4,6,6,4,16,REDACTED
1197925,1,3,4,3,3,10,REDACTED
1198330,1,7,11,20,10,41,REDACTED
1198330,2,7,10,1,8,19,REDACTED
1198330,3,0,0,0,0,0,REDACTED
1198330,4,7,6,11,7,24,REDACTED
1201267,1,6,7,7,0,14,REDACTED
1201267,2,7,4,5,0,9,REDACTED
1201267,3,4,3,4,0,7,REDACTED
1201267,5,0,5,10,0,15,REDACTED
1203420,1,11,14,5,0,19,REDACTED
1203420,2,0,0,0,0,0,REDACTED
1205585,1,5,6,8,7,21,REDACTED
1205894,1,6,6,3,1,10,REDACTED
1205894,2,2,2,1,1,4,REDACTED
1206840,1,2,2,9,0,11,REDACTED
1206840,2,4,15,10,3,28,REDACTED
1206849,1,8,8,3,9,20,REDACTED
1206849,2,7,6,8,3,17,REDACTED
1209104,1,4,5,6,17,28,REDACTED
1209104,2,4,5,2,2,9,REDACTED
1216320,1,7,7,9,7,23,REDACTED
1216320,2,6,6,2,8,16,REDACTED
1216919,1,2,2,0,0,2,REDACTED
1217174,1,4,4,8,5,17,REDACTED
1220620,1,0,0,17,15,32,REDACTED
1221265,1,0,0,3,10,13,REDACTED
1221265,2,8,12,3,11,26,REDACTED
1221265,3,0,0,3,0,3,REDACTED
1221265,4,0,0,0,0,0,REDACTED
1222333,1,6,6,5,4,15,REDACTED
1222333,2,4,5,2,4,11,REDACTED
1223485,1,6,6,2,11,19,REDACTED
1224553,1,10,7,13,8,28,REDACTED
1224553,2,8,5,0,5,10,REDACTED
1227677,1,2,2,5,2,9,REDACTED
1234445,1,0,0,0,7,7,REDACTED
1234445,2,4,4,4,7,15,REDACTED
1237062,1,4,3,4,0,7,REDACTED
1237062,2,4,4,4,0,8,REDACTED
1237062,3,5,5,0,4,9,REDACTED
1237062,4,2,2,0,0,2,REDACTED
1238063,1,7,12,9,11,32,REDACTED
1238063,2,11,11,12,5,28,REDACTED
1238063,3,6,6,5,6,17,REDACTED
1238063,4,2,10,2,7,19,REDACTED
1238063,5,0,0,0,0,0,REDACTED
1238891,1,6,7,2,7,16,REDACTED
1238891,2,6,5,2,0,7,REDACTED
1238891,3,0,0,8,0,8,REDACTED
1238891,4,4,1,0,0,1,REDACTED
1238891,5,2,4,0,0,4,REDACTED
1238983,1,4,4,5,3,12,REDACTED
1238983,2,0,0,7,0,7,REDACTED
1238983,3,3,0,0,0,0,REDACTED
1240215,1,3,3,7,4,14,REDACTED
1240215,2,3,3,3,2,8,REDACTED
1242289,1,5,5,9,7,21,REDACTED
1243366,1,2,3,2,0,5,REDACTED
1243917,1,4,5,0,0,5,REDACTED
1244338,1,8,5,3,5,13,REDACTED
1244338,2,4,4,5,4,13,REDACTED
1251980,1,6,10,6,10,26,REDACTED
1251980,2,2,2,6,9,17,REDACTED
1253990,1,3,3,5,8,16,REDACTED
1253990,2,4,2,3,4,9,REDACTED
1254545,1,6,5,7,12,24,REDACTED
1254545,2,2,4,7,13,24,REDACTED
1257772,1,6,6,2,0,8,REDACTED
1257772,2,0,0,1,11,12,REDACTED
1257772,3,12,14,2,11,27,REDACTED
1257772,4,0,0,1,9,10,REDACTED
1257772,5,2,2,2,0,4,REDACTED
1257772,6,10,14,2,8,24,REDACTED
1257772,7,7,5,2,0,7,REDACTED
1257772,8,3,3,2,13,18,REDACTED
1260078,1,0,0,0,0,0,REDACTED
1263576,1,2,3,7,7,17,REDACTED
1263576,2,10,15,11,10,36,REDACTED
1264022,1,3,3,7,4,14,REDACTED
1264022,2,5,7,4,3,14,REDACTED
1265445,1,9,3,2,1,6,REDACTED
1265445,2,3,3,4,9,16,REDACTED
1265445,3,4,8,13,1,22,REDACTED
1265784,1,6,6,2,1,9,REDACTED
1269131,1,6,6,0,7,13,REDACTED
1269131,2,4,4,0,0,4,REDACTED
1269231,1,6,6,8,3,17,REDACTED
1269231,2,10,9,5,0,14,REDACTED
1271336,1,5,6,7,2,15,REDACTED
1271462,1,7,5,12,4,21,REDACTED
1271462,2,7,10,6,7,23,REDACTED
1271889,1,0,0,0,0,0,REDACTED
1271889,2,0,0,0,0,0,REDACTED
1272227,1,0,6,8,11,25,REDACTED
1272227,2,10,8,13,11,32,REDACTED
1276395,1,2,2,0,2,4,REDACTED
1276395,2,2,2,2,0,4,REDACTED
1277787,1,6,6,5,7,18,REDACTED
1278210,1,0,0,8,0,8,REDACTED
1278210,2,7,9,3,3,15,REDACTED
1278276,1,2,3,1,0,4,REDACTED
1281468,1,4,5,4,0,9,REDACTED
1281468,2,4,5,4,0,9,REDACTED
1286478,1,9,13,22,15,50,REDACTED
1286478,2,7,11,10,2,23,REDACTED
1288207,1,7,7,11,5,23,REDACTED
1288207,2,7,10,9,0,19,REDACTED
1288207,3,2,2,0,6,8,REDACTED
1288616,2,4,5,0,3,8,REDACTED
1289586,1,2,2,4,6,12,REDACTED
1295487,1,0,0,0,0,0,REDACTED
1295919,1,3,7,10,8,25,REDACTED
1295919,2,7,13,0,0,13,REDACTED
1296011,1,7,7,2,5,14,REDACTED
1296011,2,2,26,26,26,78,REDACTED
1297587,1,9,13,13,11,37,REDACTED
1297587,2,2,2,11,9,22,REDACTED
1298797,1,3,4,5,5,14,REDACTED
1298797,2,3,4,4,2,10,REDACTED
1300089,1,6,7,4,4,15,REDACTED
1300089,2,6,9,0,10,19,REDACTED
1300089,3,2,6,18,0,24,REDACTED
1300642,1,8,2,5,9,16,REDACTED
1300991,1,12,13,5,5,23,REDACTED
1300991,2,4,4,2,1,7,REDACTED
1302033,1,2,3,6,4,13,REDACTED
1302033,2,4,5,11,3,19,REDACTED
1305092,1,9,10,22,16,48,REDACTED
1305092,2,0,0,0,11,11,REDACTED
1307522,1,5,5,7,13,25,REDACTED
1307983,1,7,8,3,5,16,REDACTED
1310704,1,12,12,3,0,15,REDACTED
1311356,1,9,11,6,11,28,REDACTED
1311859,1,8,8,0,0,8,REDACTED
1311859,2,8,8,0,0,8,REDACTED
1311989,1,3,3,11,6,20,REDACTED
1313043,1,5,6,5,2,13,REDACTED
1313043,2,6,8,4,3,15,REDACTED
1313096,1,0,0,0,0,0,REDACTED
1313096,2,9,11,6,12,29,REDACTED
1313593,1,6,6,4,3,13,REDACTED
1313593,2,9,10,0,6,16,REDACTED
1313997,1,6,5,4,13,22,REDACTED
1313997,2,3,5,0,1,6,REDACTED
1314069,1,2,4,0,3,7,REDACTED
1314069,2,7,7,0,3,10,REDACTED
1314866,1,0,0,7,7,14,REDACTED
1314866,2,0,0,0,7,7,REDACTED
1315280,1,6,6,11,5,22,REDACTED
1315280,2,3,5,7,3,15,REDACTED
1315724,1,10,11,10,2,23,REDACTED
1315724,2,4,4,7,9,20,REDACTED
1316785,1,4,5,5,10,20,REDACTED
1316785,2,4,5,5,11,21,REDACTED
1319753,1,2,2,0,4,6,REDACTED
1319753,2,6,11,14,4,29,REDACTED
1320526,1,6,10,0,3,13,REDACTED
1320792,1,2,8,3,3,14,REDACTED
1320953,1,7,17,9,12,38,REDACTED
1320953,2,4,4,6,6,16,REDACTED
1320953,3,3,11,7,8,26,REDACTED
1321010,1,0,0,6,4,10,REDACTED
1321587,1,5,6,3,0,9,REDACTED
1321587,2,5,6,2,0,8,REDACTED
1323368,1,6,6,15,4,25,REDACTED
1323368,2,3,5,6,3,14,REDACTED
1325403,1,4,8,0,4,12,REDACTED
1325403,2,4,9,0,8,17,REDACTED
1325686,1,2,1,13,3,17,REDACTED
1325686,2,6,9,8,0,17,REDACTED
1327287,1,9,10,5,19,34,REDACTED
1327287,2,8,10,18,20,48,REDACTED
1328096,1,5,5,2,3,10,REDACTED
1328096,2,7,7,4,3,14,REDACTED
1328096,3,6,11,4,7,22,REDACTED
1328163,1,0,0,0,0,0,REDACTED
1328163,2,0,0,0,0,0,REDACTED
1329631,1,8,10,0,0,10,REDACTED
1331581,1,14,18,11,0,29,REDACTED
1331581,2,6,7,7,14,28,REDACTED
1336408,1,2,2,2,4,8,REDACTED
1336408,2,2,2,2,7,11,REDACTED
1338123,1,8,9,0,0,9,REDACTED
1338349,1,4,8,4,5,17,REDACTED
1338349,2,4,9,0,0,9,REDACTED
1338349,3,5,13,9,0,22,REDACTED
1338534,1,2,2,3,4,9,REDACTED
1338534,2,2,3,1,4,8,REDACTED
1339402,1,0,0,0,5,5,REDACTED
1339402,2,9,0,10,17,27,REDACTED
1339402,3,5,8,7,18,33,REDACTED
1339402,4,0,0,2,3,5,REDACTED
1339470,1,21,24,16,2,42,REDACTED
1339470,2,0,0,5,0,5,REDACTED
1339470,3,12,26,13,0,39,REDACTED
1340572,1,12,13,16,2,31,REDACTED
1340572,2,10,10,8,20,38,REDACTED
1342185,1,7,8,3,0,11,REDACTED
1342185,2,8,4,6,0,10,REDACTED
1342643,1,12,0,3,7,10,REDACTED
1342643,2,15,16,19,6,41,REDACTED
1342643,3,5,6,9,7,22,REDACTED
1342997,1,3,4,6,4,14,REDACTED
1342997,2,0,0,2,2,4,REDACTED
1342997,3,7,11,9,17,37,REDACTED
1343322,1,4,5,4,2,11,REDACTED
1343322,2,7,7,8,6,21,REDACTED
1345717,1,2,15,3,0,18,REDACTED
1345717,2,0,0,0,0,0,REDACTED
1346828,1,7,9,8,8,25,REDACTED
1346828,2,0,1,1,4,6,REDACTED
1346828,3,7,7,8,8,23,REDACTED
1347308,1,4,5,5,9,19,REDACTED
1347308,2,8,9,11,10,30,REDACTED
1348467,1,10,15,17,10,42,REDACTED
1348723,1,0,0,5,4,9,REDACTED
1350362,1,4,4,8,12,24,REDACTED
1350362,2,17,15,15,6,36,REDACTED
1350434,1,2,5,12,9,26,REDACTED
1350434,2,3,6,10,11,27,REDACTED
1350674,1,4,3,2,2,7,REDACTED
1350674,2,7,4,4,13,21,REDACTED
1350674,3,5,4,5,16,25,REDACTED
1350674,4,4,2,3,2,7,REDACTED
1350674,5,4,7,6,12,25,REDACTED
1351613,1,5,5,7,2,14,REDACTED
1351613,2,7,9,11,9,29,REDACTED
1351654,1,15,16,16,14,46,REDACTED
1351654,2,2,2,3,4,9,REDACTED
1352129,1,11,13,17,14,44,REDACTED
1352129,2,10,10,2,7,19,REDACTED
1354508,1,4,4,1,0,5,REDACTED
1360089,1,5,7,0,1,8,REDACTED
1360089,2,3,11,2,3,16,REDACTED
1360510,1,8,8,8,6,22,REDACTED
1360575,1,5,9,14,8,31,REDACTED
1360575,2,2,3,2,4,9,REDACTED
1360575,3,2,2,9,5,16,REDACTED
1361771,1,2,2,0,0,2,REDACTED
1361771,2,0,0,0,0,0,REDACTED
1361771,3,3,6,0,0,6,REDACTED
1362489,1,0,0,6,0,6,REDACTED
1362489,2,4,5,4,3,12,REDACTED
1362489,3,2,0,3,2,5,REDACTED
1362557,1,4,6,2,8,16,REDACTED
1362557,2,5,6,7,7,20,REDACTED
1362586,1,2,5,4,2,11,REDACTED
1365175,1,15,3,0,0,3,REDACTED
1365391,1,9,8,7,10,25,REDACTED
1365391,2,2,3,8,2,13,REDACTED
1365391,3,6,5,3,4,12,REDACTED
1365818,1,3,4,0,0,4,REDACTED
1365818,2,2,0,0,0,0,REDACTED
1365818,3,2,5,6,8,19,REDACTED
1366888,1,10,10,13,7,30,REDACTED
1366888,2,4,4,2,4,10,REDACTED
1368733,1,0,0,16,6,22,REDACTED
1368733,2,10,2,4,5,11,REDACTED
1368733,3,7,9,7,0,16,REDACTED
1368733,6,2,0,0,5,5,REDACTED
1368802,1,0,0,0,2,2,REDACTED
1368802,2,2,3,0,2,5,REDACTED
1368802,3,4,3,3,2,8,REDACTED
1368802,4,0,0,0,6,6,REDACTED
1370955,1,2,6,1,2,9,REDACTED
1370955,2,2,14,9,10,33,REDACTED
1371817,1,2,3,2,3,8,REDACTED
1371817,2,2,4,5,8,17,REDACTED
1371817,3,0,7,5,8,20,REDACTED
1371926,1,4,14,0,6,20,REDACTED
1371926,2,4,5,4,6,15,REDACTED
1372257,1,4,2,0,0,2,REDACTED
1373302,1,4,10,6,6,22,REDACTED
1373302,2,0,0,0,2,2,REDACTED
1373616,1,9,10,0,0,10,REDACTED
1373616,2,3,2,0,0,2,REDACTED
1373616,3,7,9,0,0,9,REDACTED
1373616,4,11,16,0,0,16,REDACTED
1373616,5,11,15,0,0,15,REDACTED
1377126,1,4,5,10,9,24,REDACTED
1377126,2,2,2,9,8,19,REDACTED
1377952,1,6,4,8,0,12,REDACTED
1379449,1,4,6,10,10,26,REDACTED
1379781,1,11,4,6,2,12,REDACTED
1379781,2,9,8,9,11,28,REDACTED
1380172,1,8,6,17,2,25,REDACTED
1380172,2,3,3,4,4,11,REDACTED
1380199,1,0,0,0,0,0,REDACTED
1380199,2,3,3,0,1,4,REDACTED
1381218,1,4,8,4,4,16,REDACTED
1381218,2,5,5,11,5,21,REDACTED
1381218,3,2,5,8,0,13,REDACTED
1381572,1,6,6,7,9,22,REDACTED
1381572,2,10,16,11,21,48,REDACTED
1381774,1,10,13,12,5,30,REDACTED
1381774,2,8,10,12,4,26,REDACTED
1381944,1,5,4,3,8,15,REDACTED
1381944,2,5,3,9,4,16,REDACTED
1382297,1,0,0,0,6,6,REDACTED
1382297,2,8,8,0,2,10,REDACTED
1382320,1,7,8,10,4,22,REDACTED
1382320,2,6,12,0,4,16,REDACTED
1382656,1,8,8,3,3,14,REDACTED
1382656,2,6,8,12,2,22,REDACTED
1382656,3,3,3,4,4,11,REDACTED
1382656,4,2,1,4,3,8,REDACTED
1383582,1,6,9,0,8,17,REDACTED
1383582,2,8,5,8,17,30,REDACTED
1383583,1,5,6,10,5,21,REDACTED
1383583,2,8,7,4,2,13,REDACTED
1383583,3,8,7,4,0,11,REDACTED
1383839,1,7,5,5,6,16,REDACTED
1383839,2,10,10,2,18,30,REDACTED
1383853,1,7,3,3,0,6,REDACTED
1383853,2,6,2,3,0,5,REDACTED
1383853,3,4,2,2,0,4,REDACTED
1383853,4,12,4,3,0,7,REDACTED
1383853,5,11,5,9,10,24,REDACTED
1384775,1,0,0,0,0,0,REDACTED
1384775,2,4,5,0,0,5,REDACTED
1390913,1,4,4,2,9,15,REDACTED
1390913,2,0,0,6,16,22,REDACTED
1392411,1,5,0,0,0,0,REDACTED
1392411,2,11,14,10,10,34,REDACTED
1392411,3,10,19,5,5,29,REDACTED
1392915,1,6,2,2,0,4,REDACTED
1392915,3,4,2,39,38,79,REDACTED
1392915,4,4,6,1,36,43,REDACTED
1393607,1,4,8,6,0,14,REDACTED
1393607,2,9,10,3,7,20,REDACTED
1393814,1,8,12,6,3,21,REDACTED
1393814,2,2,2,3,2,7,REDACTED
1395854,1,3,3,3,5,11,REDACTED
1395854,2,5,5,2,12,19,REDACTED
1396611,1,4,6,2,1,9,REDACTED
1396611,2,6,4,6,8,18,REDACTED
1396611,3,3,26,0,0,26,REDACTED
1396611,4,2,7,13,10,30,REDACTED
1396945,1,2,14,4,10,28,REDACTED
1396945,2,2,2,4,5,11,REDACTED
1397218,1,2,0,5,0,5,REDACTED
1397218,2,0,0,3,3,6,REDACTED
1397218,3,3,2,1,0,3,REDACTED
1399011,1,3,3,12,13,28,REDACTED
1399011,2,5,5,12,15,32,REDACTED
1399693,1,8,3,3,6,12,REDACTED
1399693,2,0,1,8,3,12,REDACTED
1399703,1,5,3,10,8,21,REDACTED
1399703,2,4,4,3,4,11,REDACTED
1399703,3,6,7,0,0,7,REDACTED
1399703,4,2,0,5,0,5,REDACTED
1400451,1,7,5,6,3,14,REDACTED
1400664,1,4,4,2,0,6,REDACTED
1400664,2,5,6,6,2,14,REDACTED
1400727,1,6,6,4,11,21,REDACTED
1401062,1,6,4,4,3,11,REDACTED
1401062,2,6,7,4,5,16,REDACTED
1401065,1,4,3,4,10,17,REDACTED
1401065,2,2,2,11,2,15,REDACTED
1401091,1,9,13,5,6,24,REDACTED
1401091,2,5,8,8,11,27,REDACTED
1401091,3,7,38,19,2,59,REDACTED
1401091,4,5,8,2,2,12,REDACTED
1401220,1,4,5,10,0,15,REDACTED
1401220,2,7,8,5,7,20,REDACTED
1401414,1,8,9,0,0,9,REDACTED
1401414,2,5,6,0,0,6,REDACTED
1401414,3,2,0,0,0,0,REDACTED
1401502,1,0,0,5,4,9,REDACTED
1401502,2,6,6,3,4,13,REDACTED
1401507,1,9,14,7,4,25,REDACTED
1401507,2,3,3,5,2,10,REDACTED
1401761,1,1,6,0,0,6,REDACTED
1401984,1,3,8,10,7,25,REDACTED
1402016,1,4,4,5,4,13,REDACTED
1402016,2,4,4,5,4,13,REDACTED
1402050,1,6,18,5,8,31,REDACTED
1402050,2,0,5,5,0,10,REDACTED
1402216,1,0,0,0,0,0,REDACTED
1402216,2,2,1,0,0,1,REDACTED
1402216,3,0,0,0,0,0,REDACTED
1402216,4,3,4,0,0,4,REDACTED
1402219,1,3,7,5,6,18,REDACTED
1402219,2,8,4,4,7,15,REDACTED
1402225,1,3,3,7,2,12,REDACTED
1402225,2,2,2,7,2,11,REDACTED
1402560,1,4,8,9,1,18,REDACTED
1402560,2,7,12,3,1,16,REDACTED
1402560,3,10,5,7,0,12,REDACTED
1402864,1,3,11,6,2,19,REDACTED
1403033,1,0,0,0,0,0,REDACTED
1403542,1,8,11,9,8,28,REDACTED
1403542,2,4,3,5,3,11,REDACTED
1403542,3,4,5,2,3,10,REDACTED
1403711,1,2,10,8,3,21,REDACTED
1403711,2,3,8,4,0,12,REDACTED
1404062,1,4,1,21,7,29,REDACTED
1404062,2,2,2,2,4,8,REDACTED
1404071,1,5,6,11,10,27,REDACTED
1404071,2,14,13,6,5,24,REDACTED
1404254,1,7,8,7,0,15,REDACTED
1404277,1,2,2,3,2,7,REDACTED
1404556,1,5,6,6,4,16,REDACTED
1404809,1,6,5,2,7,14,REDACTED
1404809,2,3,1,2,1,4,REDACTED
1405461,1,6,8,5,4,17,REDACTED
1405469,1,4,14,6,3,23,REDACTED
1405469,2,4,6,8,5,19,REDACTED
1405500,1,2,3,3,3,9,REDACTED
1405500,2,2,2,4,3,9,REDACTED
1405500,3,0,0,0,0,0,REDACTED
1405758,1,4,4,8,6,18,REDACTED
1405758,2,4,2,10,6,18,REDACTED
1406374,1,4,5,8,3,16,REDACTED
1406526,1,0,0,0,3,3,REDACTED
1406695,1,4,5,0,4,9,REDACTED
1406695,2,2,4,8,5,17,REDACTED
1407506,1,4,12,0,0,12,REDACTED
1407506,2,2,6,0,0,6,REDACTED
1407624,1,7,14,3,5,22,REDACTED
1407624,2,13,2,7,10,19,REDACTED
1407783,1,9,10,10,12,32,REDACTED
1407783,2,9,9,5,17,31,REDACTED
1408058,1,5,5,0,2,7,REDACTED
1408153,1,6,8,16,0,24,REDACTED
1408153,2,2,8,0,0,8,REDACTED
1408500,1,7,11,10,4,25,REDACTED
1408666,1,6,7,9,5,21,REDACTED
1408666,2,6,7,9,9,25,REDACTED
1409214,1,4,4,0,8,12,REDACTED
1409214,2,7,11,8,7,26,REDACTED
1409347,1,2,6,5,4,15,REDACTED
1409347,2,13,7,5,7,19,REDACTED
1409690,1,2,2,0,0,2,REDACTED
1409690,2,2,2,0,0,2,REDACTED
1409775,1,6,7,5,4,16,REDACTED
1409775,2,14,15,3,5,23,REDACTED
1409775,3,4,3,2,2,7,REDACTED
1410233,1,0,0,0,0,0,REDACTED
1410233,2,2,2,4,2,8,REDACTED
1410286,1,7,7,13,5,25,REDACTED
1410286,2,5,8,6,4,18,REDACTED
1410336,1,10,11,6,5,22,REDACTED
1410336,2,6,6,5,6,17,REDACTED
1411200,1,4,3,7,12,22,REDACTED
1411200,2,2,3,5,6,14,REDACTED
1411499,1,13,14,0,17,31,REDACTED
1412114,1,2,2,5,2,9,REDACTED
1412114,2,5,6,9,6,21,REDACTED
1412205,1,4,4,2,5,11,REDACTED
1412411,1,9,8,14,12,34,REDACTED
1412411,2,10,4,7,12,23,REDACTED
1412411,3,0,7,4,0,11,REDACTED
1412411,4,0,0,10,13,23,REDACTED
1413043,1,6,9,9,5,23,REDACTED
1413091,1,0,0,7,4,11,REDACTED
1414126,1,3,3,1,5,9,REDACTED
1414264,1,8,0,1,3,4,REDACTED
1414264,2,2,2,3,4,9,REDACTED
1414264,3,9,5,7,0,12,REDACTED
1414675,1,8,10,4,5,19,REDACTED
1414675,2,4,4,5,3,12,REDACTED
1415236,1,6,6,14,4,24,REDACTED
1415236,2,10,11,6,4,21,REDACTED
1415700,1,6,6,0,0,6,REDACTED
1415988,1,6,8,7,20,35,REDACTED
1415988,2,10,10,12,11,33,REDACTED
1416023,1,4,4,7,8,19,REDACTED
1416023,2,5,10,8,0,18,REDACTED
1416253,1,2,2,7,4,13,REDACTED
1416253,2,2,2,0,2,4,REDACTED
1416483,1,14,16,16,28,60,REDACTED
1416878,1,8,8,8,5,21,REDACTED
1416878,2,3,2,4,2,8,REDACTED
1416933,1,12,17,3,8,28,REDACTED
1416933,2,4,5,15,3,23,REDACTED
1417459,1,8,6,3,4,13,REDACTED
1417459,2,0,5,0,4,9,REDACTED
1417481,1,3,3,2,6,11,REDACTED
1417571,1,4,6,4,0,10,REDACTED
1417571,2,0,0,10,0,10,REDACTED
1417829,1,8,8,2,7,17,REDACTED
1417829,2,6,7,0,7,14,REDACTED
1417829,3,7,12,2,2,16,REDACTED
1417970,1,4,4,0,6,10,REDACTED
1417970,2,2,1,2,6,9,REDACTED
1418036,1,7,7,8,8,23,REDACTED
1418141,1,4,4,10,9,23,REDACTED
1418141,2,4,3,4,1,8,REDACTED
1418292,1,12,14,13,5,32,REDACTED
1418292,2,0,0,0,0,0,REDACTED
1418363,1,7,11,5,12,28,REDACTED
1419130,1,7,19,9,10,38,REDACTED
1419130,2,10,11,5,11,27,REDACTED
1419130,3,4,10,2,8,20,REDACTED
1419459,1,4,9,4,3,16,REDACTED
1420334,1,4,8,8,0,16,REDACTED
1421052,1,3,3,0,3,6,REDACTED
1421052,2,3,3,1,0,4,REDACTED
1421226,1,5,5,5,1,11,REDACTED
1421695,1,0,1,8,9,18,REDACTED
1421695,2,10,7,9,3,19,REDACTED
1421695,3,4,8,4,6,18,REDACTED
1423009,1,14,14,9,0,23,REDACTED
1423009,2,5,5,5,7,17,REDACTED
1423284,1,0,1,4,1,6,REDACTED
1423284,2,5,5,7,3,15,REDACTED
1423347,1,5,6,6,5,17,REDACTED
1423347,2,2,4,6,0,10,REDACTED
1423388,1,2,2,0,0,2,REDACTED
1423388,2,2,2,0,0,2,REDACTED
1423388,3,2,7,0,0,7,REDACTED
1423641,1,5,20,7,4,31,REDACTED
1423641,2,7,7,7,7,21,REDACTED
1423642,1,6,2,2,0,4,REDACTED
1424002,1,6,1,4,1,6,REDACTED
1424002,2,4,2,2,0,4,REDACTED
1424084,1,7,12,5,1,18,REDACTED
1424084,2,3,1,2,0,3,REDACTED
1424097,1,2,2,0,0,2,REDACTED
1424097,2,6,3,0,0,3,REDACTED
1424373,1,10,11,16,3,30,REDACTED
1424845,1,3,17,9,27,53,REDACTED
1424845,2,4,5,11,8,24,REDACTED
1424845,3,2,2,9,8,19,REDACTED
1424888,1,11,9,10,2,21,REDACTED
1424888,2,13,12,10,18,40,REDACTED
1425142,1,3,1,6,3,10,REDACTED
1425142,2,3,4,6,4,14,REDACTED
1425459,1,4,6,0,0,6,REDACTED
1425459,2,2,3,0,0,3,REDACTED
1425459,3,5,11,9,0,20,REDACTED
1425734,1,6,5,5,3,13,REDACTED
1425734,2,5,6,6,10,22,REDACTED
1426099,1,0,0,3,0,3,REDACTED
1426099,2,3,4,3,7,14,REDACTED
1426099,3,8,20,5,0,25,REDACTED
1426099,4,2,0,0,3,3,REDACTED
1426808,1,5,8,2,5,15,REDACTED
1426808,2,0,0,0,0,0,REDACTED
1426971,1,4,6,5,8,19,REDACTED
1427743,1,8,10,9,8,27,REDACTED
1428793,1,4,4,0,2,6,REDACTED
1428793,2,4,3,15,3,21,REDACTED
1428932,3,2,18,1,0,19,REDACTED
1428999,1,0,0,0,3,3,REDACTED
1428999,2,2,1,1,1,3,REDACTED
1429511,1,21,21,12,6,39,REDACTED
1430715,1,6,5,7,10,22,REDACTED
1430720,1,3,7,0,0,7,REDACTED
1430720,2,0,0,0,0,0,REDACTED
1431481,1,5,7,6,13,26,REDACTED
1431481,2,8,5,7,0,12,REDACTED
1431576,1,3,4,0,0,4,REDACTED
1431576,2,0,0,0,0,0,REDACTED
1431727,1,10,12,6,3,21,REDACTED
1431727,2,5,5,4,1,10,REDACTED
1432381,1,6,7,7,2,16,REDACTED
1432381,2,6,8,9,7,24,REDACTED
1432531,1,8,6,11,4,21,REDACTED
1432531,2,4,4,8,6,18,REDACTED
1432536,1,0,0,6,6,12,REDACTED
1432536,2,5,6,14,8,28,REDACTED
1433347,1,7,12,10,9,31,REDACTED
1433347,2,7,5,2,3,10,REDACTED
1435087,1,6,6,6,3,15,REDACTED
1435087,2,2,5,0,4,9,REDACTED
1435171,1,2,2,3,1,6,REDACTED
1435450,1,2,2,5,4,11,REDACTED
1435615,1,5,5,9,5,19,REDACTED
1435615,2,4,4,16,14,34,REDACTED
1435615,3,3,3,4,3,10,REDACTED
1435784,1,3,5,0,0,5,REDACTED
1435784,2,5,8,0,4,12,REDACTED
1436534,1,10,9,19,11,39,REDACTED
1436629,1,6,6,0,1,7,REDACTED
1437046,1,6,7,11,7,25,REDACTED
1437046,2,6,5,9,5,19,REDACTED
1437129,1,6,4,5,5,14,REDACTED
1437129,2,8,9,4,5,18,REDACTED
1437129,3,4,5,3,5,13,REDACTED
1437476,1,4,4,4,3,11,REDACTED
1437593,1,10,8,9,3,20,REDACTED
1437782,1,0,1,9,5,15,REDACTED
1437782,2,8,16,0,0,16,REDACTED
1438010,1,0,0,0,0,0,REDACTED
1438674,1,7,7,3,0,10,REDACTED
1438674,2,6,6,7,0,13,REDACTED
1438713,1,4,5,7,5,17,REDACTED
1438713,2,3,3,3,0,6,REDACTED
1439359,1,0,0,0,0,0,REDACTED
1439600,1,2,8,5,0,13,REDACTED
1439600,2,0,75,68,0,143,REDACTED
1440062,1,15,16,8,10,34,REDACTED
1440062,2,8,13,12,11,36,REDACTED
1440125,1,10,10,0,0,10,REDACTED
1440125,2,4,1,0,0,1,REDACTED
1440125,3,4,5,0,0,5,REDACTED
1440133,1,3,3,8,3,14,REDACTED
1440204,1,2,3,2,0,5,REDACTED
1440204,2,2,4,5,0,9,REDACTED
1440787,1,0,0,8,0,8,REDACTED
1440787,2,0,0,5,3,8,REDACTED
1441301,1,4,4,3,10,17,REDACTED
1441301,2,4,3,4,18,25,REDACTED
1441369,1,5,4,5,2,11,REDACTED
1441497,1,5,1,1,3,5,REDACTED
1442328,1,0,0,2,2,4,REDACTED
1442328,2,8,10,3,13,26,REDACTED
1442550,1,10,11,0,0,11,REDACTED
1442550,2,0,0,0,0,0,REDACTED
1442580,1,6,6,5,15,26,REDACTED
1442580,2,5,5,4,3,12,REDACTED
1443035,1,2,2,14,8,24,REDACTED
1443035,2,0,0,2,0,2,REDACTED
1443181,1,3,4,13,3,20,REDACTED
1443181,2,2,0,0,0,0,REDACTED
1443181,3,6,8,0,3,11,REDACTED
1443466,1,14,13,8,8,29,REDACTED
1443466,2,7,5,5,9,19,REDACTED
1444009,1,11,2,11,7,20,REDACTED
1444237,2,5,3,4,5,12,REDACTED
1444737,1,5,5,10,1,16,REDACTED
1444737,2,4,9,9,5,23,REDACTED
1445016,1,4,6,2,0,8,REDACTED
1445016,2,1,2,0,0,2,REDACTED
1445369,1,9,9,0,0,9,REDACTED
1445369,2,5,5,0,0,5,REDACTED
1446111,1,10,10,6,8,24,REDACTED
1446567,1,4,1,7,13,21,REDACTED
1446567,2,6,11,12,10,33,REDACTED
1447133,1,4,4,2,2,8,REDACTED
1447133,2,2,2,3,2,7,REDACTED
1447679,1,8,7,5,2,14,REDACTED
1447679,2,6,6,3,6,15,REDACTED
1448287,1,6,7,11,0,18,REDACTED
1448333,1,5,5,0,0,5,REDACTED
1448333,2,7,12,0,0,12,REDACTED
1449872,1,5,8,0,0,8,REDACTED
1449872,2,2,2,0,0,2,REDACTED
1451605,1,4,4,1,0,5,REDACTED
1452337,1,9,30,13,14,57,REDACTED
1452337,2,6,9,5,5,19,REDACTED
1452469,1,9,8,10,8,26,REDACTED
1452469,2,3,3,1,1,5,REDACTED
1452518,1,2,4,2,5,11,REDACTED
1452518,2,3,4,7,9,20,REDACTED
1452535,1,5,6,7,13,26,REDACTED
1452535,2,2,3,4,5,12,REDACTED
1452586,1,8,6,3,18,27,REDACTED
1452586,2,14,11,0,10,21,REDACTED
1452613,1,6,7,10,0,17,REDACTED
1452620,1,4,6,2,0,8,REDACTED
1452620,2,1,1,0,0,1,REDACTED
1452668,1,11,11,3,9,23,REDACTED
1452668,2,6,3,4,5,12,REDACTED
1452668,3,4,5,7,0,12,REDACTED
1452803,1,0,0,6,0,6,REDACTED
1452803,2,6,7,7,2,16,REDACTED
1452915,1,8,8,7,5,20,REDACTED
1452915,2,6,16,2,5,23,REDACTED
1452982,1,6,6,7,3,16,REDACTED
1452982,2,6,11,3,2,16,REDACTED
1453465,1,6,5,0,2,7,REDACTED
1453480,1,10,0,0,0,0,REDACTED
1453480,2,7,0,0,0,0,REDACTED
1453480,3,5,3,12,10,25,REDACTED
1453480,4,5,5,10,4,19,REDACTED
1453614,1,6,3,10,34,47,REDACTED
1453614,2,4,2,9,36,47,REDACTED
1453833,1,11,13,11,11,35,REDACTED
1453833,2,11,13,5,10,28,REDACTED
1453864,1,5,5,0,0,5,REDACTED
1454172,1,6,6,9,7,22,REDACTED
1454172,2,6,8,8,9,25,REDACTED
1454549,1,8,8,0,9,17,REDACTED
1454549,2,7,10,3,3,16,REDACTED
1454564,1,2,2,10,2,14,REDACTED
1455851,1,2,4,0,1,5,REDACTED
1455851,2,2,4,0,2,6,REDACTED
1455927,1,6,4,5,0,9,REDACTED
1456024,1,9,9,6,3,18,REDACTED
1456024,2,0,0,0,0,0,REDACTED
1456036,1,2,7,5,8,20,REDACTED
1456036,2,2,4,11,5,20,REDACTED
1456161,1,9,9,4,0,13,REDACTED
1456161,2,0,0,0,0,0,REDACTED
1456671,2,8,7,3,8,18,REDACTED
1456671,3,4,4,4,6,14,REDACTED
1456838,1,3,4,5,9,18,REDACTED
1456838,2,5,5,5,8,18,REDACTED
1457273,1,2,3,2,3,8,REDACTED
1457273,2,2,2,1,2,5,REDACTED
1457273,3,9,18,16,0,34,REDACTED
1457286,1,6,7,1,3,11,REDACTED
1457286,2,3,3,5,15,23,REDACTED
1457286,3,6,4,3,8,15,REDACTED
1457286,4,3,3,5,3,11,REDACTED
1458245,1,6,6,5,4,15,REDACTED
1458245,2,10,11,5,0,16,REDACTED
1458355,1,6,6,6,8,20,REDACTED
1458355,2,2,2,5,5,12,REDACTED
1458388,1,18,20,14,0,34,REDACTED
1458388,2,11,1,14,10,25,REDACTED
1458613,1,1,0,0,0,0,REDACTED
1458613,2,0,0,0,0,0,REDACTED
1458613,3,0,0,0,0,0,REDACTED
1459041,1,7,7,4,3,14,REDACTED
1459041,2,7,4,12,5,21,REDACTED
1459402,1,0,0,0,0,0,REDACTED
1459509,1,4,4,7,5,16,REDACTED
1459509,2,0,0,0,0,0,REDACTED
1459723,1,0,0,3,4,7,REDACTED
1459809,1,2,3,6,4,13,REDACTED
1460101,1,5,4,5,5,14,REDACTED
1460101,2,17,12,20,15,47,REDACTED
1460285,1,6,4,0,5,9,REDACTED
1460384,1,9,9,7,9,25,REDACTED
1460384,2,5,2,5,8,15,REDACTED
1460679,1,2,3,6,0,9,REDACTED
1460679,2,0,2,4,0,6,REDACTED
1460679,3,2,3,0,0,3,REDACTED
1461247,1,3,3,0,0,3,REDACTED
1461303,3,10,16,4,0,20,REDACTED
1461383,1,14,10,1,0,11,REDACTED
1461383,2,6,14,7,0,21,REDACTED
1461383,3,6,8,12,0,20,REDACTED
1462259,1,5,8,7,7,22,REDACTED
1462600,1,11,13,9,13,35,REDACTED
1462600,2,7,8,3,3,14,REDACTED
1462881,1,5,6,9,10,25,REDACTED
1463095,1,2,2,0,0,2,REDACTED
1463095,2,0,4,0,0,4,REDACTED
1463144,1,3,3,3,0,6,REDACTED
1463144,2,2,2,2,6,10,REDACTED
1463288,1,2,4,5,1,10,REDACTED
1463288,2,2,3,4,1,8,REDACTED
1463370,1,4,4,7,9,20,REDACTED
1463370,2,5,7,8,3,18,REDACTED
1463421,1,5,5,5,0,10,REDACTED
1463421,2,7,3,0,0,3,REDACTED
1463421,3,4,0,0,0,0,REDACTED
1463628,1,5,1,0,4,5,REDACTED
1463831,1,4,4,9,10,23,REDACTED
1463831,2,7,7,13,7,27,REDACTED
1463905,1,2,2,0,2,4,REDACTED
1463905,2,3,3,8,0,11,REDACTED
1464567,1,0,0,0,0,0,REDACTED
1464567,2,0,0,0,0,0,REDACTED
1464567,3,0,0,0,0,0,REDACTED
1464676,1,7,10,12,0,22,REDACTED
1464676,2,8,13,12,0,25,REDACTED
1465095,1,2,2,4,4,10,REDACTED
1465095,2,4,6,2,0,8,REDACTED
1465164,1,6,6,0,14,20,REDACTED
1465250,1,6,5,9,8,22,REDACTED
1465359,1,15,15,9,16,40,REDACTED
1466079,1,3,5,0,0,5,REDACTED
1466079,2,0,0,0,0,0,REDACTED
1466137,1,10,11,0,0,11,REDACTED
1466137,2,3,3,4,2,9,REDACTED
1466137,3,3,2,0,0,2,REDACTED
1466404,1,7,9,4,10,23,REDACTED
1466404,2,3,3,2,2,7,REDACTED
1466613,1,2,2,2,0,4,REDACTED
1466613,2,0,0,0,6,6,REDACTED
1466613,3,2,4,4,0,8,REDACTED
1466793,1,9,10,6,2,18,REDACTED
1466793,2,5,5,0,7,12,REDACTED
1466793,3,4,4,13,8,25,REDACTED
1466793,4,3,5,0,0,5,REDACTED
1466793,5,4,5,5,2,12,REDACTED
1466877,1,6,8,0,5,13,REDACTED
1467073,1,9,11,5,8,24,REDACTED
1467073,2,9,11,6,8,25,REDACTED
1467253,1,8,10,6,0,16,REDACTED
1467488,1,9,11,10,8,29,REDACTED
1467488,2,5,6,12,8,26,REDACTED
1468356,1,4,4,12,16,32,REDACTED
1468356,2,4,4,3,0,7,REDACTED
1468748,1,5,7,9,5,21,REDACTED
1468748,2,3,3,3,0,6,REDACTED
1470082,1,7,4,8,16,28,REDACTED
1470325,1,3,3,2,2,7,REDACTED
1470325,2,6,6,3,5,14,REDACTED
1470335,1,5,6,7,4,17,REDACTED
1470335,2,0,0,2,4,6,REDACTED
1470792,1,0,0,0,0,0,REDACTED
1471197,1,3,3,3,10,16,REDACTED
1471197,2,0,0,10,14,24,REDACTED
1471197,3,6,12,12,11,35,REDACTED
1471289,1,3,7,0,0,7,REDACTED
1471289,2,5,8,11,0,19,REDACTED
1471415,1,5,6,10,12,28,REDACTED
1471415,2,2,3,6,5,14,REDACTED
1471549,1,6,6,3,4,13,REDACTED
1471549,2,5,4,0,4,8,REDACTED
1471549,3,16,18,18,14,50,REDACTED
1471549,4,6,9,7,30,46,REDACTED
1471768,1,4,4,2,2,8,REDACTED
1471768,2,3,3,5,4,12,REDACTED
1471960,1,4,8,6,5,19,REDACTED
1471960,2,0,0,3,2,5,REDACTED
1472664,1,4,4,7,0,11,REDACTED
1472664,2,3,2,4,0,6,REDACTED
1472827,1,7,3,12,6,21,REDACTED
1472827,2,2,2,12,7,21,REDACTED
1473154,1,5,7,8,3,18,REDACTED
1473154,2,0,0,8,9,17,REDACTED
1473154,3,6,6,8,0,14,REDACTED
1473154,4,0,0,1,0,1,REDACTED
1473715,1,6,4,5,3,12,REDACTED
1473715,2,9,9,2,0,11,REDACTED
1473894,1,9,9,3,2,14,REDACTED
1473894,2,4,4,3,0,7,REDACTED
1474620,1,5,4,10,2,16,REDACTED
1474620,2,6,1,0,9,10,REDACTED
1474991,1,4,5,7,7,19,REDACTED
1474991,2,11,5,2,5,12,REDACTED
1475220,1,0,0,7,0,7,REDACTED
1475800,1,6,2,6,1,9,REDACTED
1475800,2,2,4,6,0,10,REDACTED
1476119,1,2,2,8,0,10,REDACTED
1476119,2,3,4,19,0,23,REDACTED
1476661,1,0,0,6,3,9,REDACTED
1476771,1,10,7,3,8,18,REDACTED
1476771,2,0,0,0,0,0,REDACTED
1477286,1,12,12,8,10,30,REDACTED
1477286,2,11,13,13,8,34,REDACTED
1477893,1,4,4,9,9,22,REDACTED
1477893,2,4,2,7,7,16,REDACTED
1478280,1,13,20,0,0,20,REDACTED
1478419,1,6,12,21,15,48,REDACTED
1478684,1,3,6,0,5,11,REDACTED
1479026,1,3,3,3,2,8,REDACTED
1479109,1,8,5,7,8,20,REDACTED
1479109,2,6,1,6,13,20,REDACTED
1479109,3,2,4,3,0,7,REDACTED
1479190,1,8,7,5,5,17,REDACTED
1479190,2,0,0,2,5,7,REDACTED
1479233,1,5,9,9,8,26,REDACTED
1479233,2,2,3,7,7,17,REDACTED
1479351,1,6,6,10,5,21,REDACTED
1479351,2,11,13,4,6,23,REDACTED
1479351,3,2,2,5,2,9,REDACTED
1479351,4,0,2,2,0,4,REDACTED
1479757,1,2,8,0,0,8,REDACTED
1479757,2,6,6,0,0,6,REDACTED
1479757,3,0,0,0,0,0,REDACTED
1480008,1,5,7,9,0,16,REDACTED
1480243,1,4,3,4,0,7,REDACTED
1480243,2,2,8,9,3,20,REDACTED
1480394,1,0,5,7,7,19,REDACTED
1480512,1,2,2,5,0,7,REDACTED
1480512,2,4,2,5,0,7,REDACTED
1480512,3,2,0,0,0,0,REDACTED
1480613,1,6,9,0,0,9,REDACTED
1480613,2,0,0,0,0,0,REDACTED
1480857,1,5,9,0,0,9,REDACTED
1480857,2,2,1,0,0,1,REDACTED
1481136,1,6,35,28,3,66,REDACTED
1481136,2,0,0,0,0,0,REDACTED
1481136,3,0,4,3,0,7,REDACTED
1481289,1,2,4,5,6,15,REDACTED
1481289,2,2,4,4,1,9,REDACTED
1482254,2,6,6,0,0,6,REDACTED
1483152,1,8,8,3,9,20,REDACTED
1483152,2,11,14,11,13,38,REDACTED
1483750,1,0,0,5,5,10,REDACTED
1483750,2,2,1,2,7,10,REDACTED
1484218,1,2,2,7,3,12,REDACTED
1484218,2,2,3,2,3,8,REDACTED
1484309,1,8,8,7,8,23,REDACTED
1484385,1,6,6,3,5,14,REDACTED
1484385,2,5,2,2,2,6,REDACTED
1485088,1,6,7,8,5,20,REDACTED
1485307,1,5,5,0,0,5,REDACTED
1485307,2,3,4,0,0,4,REDACTED
1485392,1,7,9,6,0,15,REDACTED
1485392,2,0,0,7,8,15,REDACTED
1485522,1,7,7,9,0,16,REDACTED
1485522,2,2,3,9,0,12,REDACTED
1485619,1,2,2,3,3,8,REDACTED
1485827,1,4,4,1,2,7,REDACTED
1486219,2,4,6,4,12,22,REDACTED
1487654,1,0,0,4,0,4,REDACTED
1487654,2,2,2,0,0,2,REDACTED
1488049,1,7,8,6,0,14,REDACTED
1488049,2,10,12,0,0,12,REDACTED
1488097,1,3,4,6,0,10,REDACTED
1488097,2,4,8,9,11,28,REDACTED
1488156,1,6,6,9,14,29,REDACTED
1488156,2,8,14,15,9,38,REDACTED
1488313,1,6,7,7,7,21,REDACTED
1488313,2,4,6,0,3,9,REDACTED
1489029,1,12,13,16,12,41,REDACTED
1489029,2,5,6,9,2,17,REDACTED
1489029,3,3,1,8,9,18,REDACTED
1489279,1,0,0,0,0,0,REDACTED
1489279,2,0,0,0,0,0,REDACTED
1489338,1,0,0,0,0,0,REDACTED
1489338,2,0,0,0,0,0,REDACTED
1489454,1,5,4,3,4,11,REDACTED
1489454,2,5,5,0,2,7,REDACTED
1489528,1,6,6,6,7,19,REDACTED
1489528,2,3,3,12,4,19,REDACTED
1489758,1,5,10,6,7,23,REDACTED
1489864,1,3,4,3,1,8,REDACTED
1489864,2,6,4,2,2,8,REDACTED
1490254,1,5,8,6,0,14,REDACTED
1490467,1,0,0,10,0,10,REDACTED
1490467,2,0,0,0,2,2,REDACTED
1490741,1,11,3,8,4,15,REDACTED
1490741,2,9,4,5,7,16,REDACTED
1490945,1,3,10,3,12,25,REDACTED
1490945,2,0,0,3,7,10,REDACTED
1491180,1,0,0,0,0,0,REDACTED
1491726,1,8,6,5,0,11,REDACTED
1491726,2,7,9,3,0,12,REDACTED
1492549,1,5,5,1,0,6,REDACTED
1492549,2,5,5,2,0,7,REDACTED
1492997,1,4,6,7,10,23,REDACTED
1492997,2,0,2,14,0,16,REDACTED
1493200,1,0,0,5,3,8,REDACTED
1493383,1,2,4,4,6,14,REDACTED
1493400,2,4,4,3,4,11,REDACTED
1493487,1,12,12,7,10,29,REDACTED
1493487,2,3,8,8,7,23,REDACTED
1493487,3,2,3,6,7,16,REDACTED
1493604,1,8,7,6,0,13,REDACTED
1493649,1,3,7,5,8,20,REDACTED
1493649,2,7,6,3,3,12,REDACTED
1493678,1,4,2,5,2,9,REDACTED
1493851,1,6,6,4,6,16,REDACTED
1493851,2,13,13,13,8,34,REDACTED
1494055,1,6,7,10,4,21,REDACTED
1494244,1,8,4,0,9,13,REDACTED
1494244,2,0,0,6,9,15,REDACTED
1494422,1,4,8,8,0,16,REDACTED
1494422,2,4,3,6,0,9,REDACTED
1495334,1,6,6,0,0,6,REDACTED
1495334,2,6,6,0,0,6,REDACTED
1495515,1,0,0,3,3,6,REDACTED
1495623,1,0,0,4,1,5,REDACTED
1495689,1,8,5,8,3,16,REDACTED
1495689,2,13,3,5,7,15,REDACTED
1496092,1,9,11,9,7,27,REDACTED
1496092,2,3,5,10,3,18,REDACTED
1497082,1,5,8,0,0,8,REDACTED
1497082,2,4,4,0,0,4,REDACTED
1497287,1,6,6,2,1,9,REDACTED
1497287,2,4,3,11,12,26,REDACTED
1497337,1,2,2,2,2,6,REDACTED
1497337,2,6,6,15,3,24,REDACTED
1497608,1,2,3,4,11,18,REDACTED
1497608,2,4,5,12,16,33,REDACTED
1497788,1,14,15,8,8,31,REDACTED
1497788,2,6,5,7,11,23,REDACTED
1498504,1,4,1,6,0,7,REDACTED
1498587,1,2,2,7,9,18,REDACTED
1498587,2,6,6,8,7,21,REDACTED
1498756,1,4,4,5,2,11,REDACTED
1498815,1,8,4,3,7,14,REDACTED
1498936,1,2,2,2,4,8,REDACTED
1498936,2,3,5,1,0,6,REDACTED
1498957,1,15,15,5,3,23,REDACTED
1499177,1,0,0,3,0,3,REDACTED
1499177,2,2,2,2,2,6,REDACTED
1500403,1,8,7,6,0,13,REDACTED
1500403,2,9,5,7,0,12,REDACTED
1500935,1,10,9,2,4,15,REDACTED
1500935,2,15,10,9,5,24,REDACTED
1501118,1,12,15,0,9,24,REDACTED
1501118,2,7,7,0,6,13,REDACTED
1502500,1,5,11,11,5,27,REDACTED
1502500,2,8,13,12,0,25,REDACTED
1502650,1,8,8,2,0,10,REDACTED
1502650,2,10,13,3,0,16,REDACTED
1502871,1,0,0,0,2,2,REDACTED
1502871,2,3,3,2,4,9,REDACTED
1503228,1,2,1,1,5,7,REDACTED
1503228,2,2,4,6,0,10,REDACTED
1504148,1,4,4,10,4,18,REDACTED
1504148,2,2,5,12,4,21,REDACTED
1504746,1,7,7,5,9,21,REDACTED
1504746,2,8,9,17,7,33,REDACTED
1504746,3,11,20,10,11,41,REDACTED
1504768,1,6,8,0,0,8,REDACTED
1504768,2,2,8,0,0,8,REDACTED
1504922,1,3,2,5,4,11,REDACTED
1504922,2,0,2,5,4,11,REDACTED
1504922,3,2,5,15,8,28,REDACTED
1504922,4,2,2,2,2,6,REDACTED
1504935,1,6,6,8,10,24,REDACTED
1505412,1,5,2,3,0,5,REDACTED
1505708,1,2,3,3,2,8,REDACTED
1505708,2,5,5,3,3,11,REDACTED
1506707,1,5,5,0,5,10,REDACTED
1506939,1,11,14,7,2,23,REDACTED
1506939,2,5,4,14,3,21,REDACTED
1507195,1,2,14,0,0,14,REDACTED
1507195,2,0,6,0,0,6,REDACTED
1507195,3,12,0,4,0,4,REDACTED
1507195,4,2,0,0,0,0,REDACTED
1507560,1,6,11,4,10,25,REDACTED
1507560,2,5,1,0,0,1,REDACTED
1508142,1,3,14,10,0,24,REDACTED
1508142,2,3,4,1,0,5,REDACTED
1508412,1,4,5,0,0,5,REDACTED
1508412,2,0,0,0,0,0,REDACTED
1509183,1,18,22,20,26,68,REDACTED
1509183,2,2,8,4,18,30,REDACTED
1509209,1,10,4,11,0,15,REDACTED
1509209,2,10,3,4,0,7,REDACTED
1509209,3,6,15,5,0,20,REDACTED
1509422,1,5,5,8,16,29,REDACTED
1509422,2,5,6,9,3,18,REDACTED
1509619,1,5,11,11,6,28,REDACTED
1509619,2,0,0,1,0,1,REDACTED
1510060,1,7,5,4,7,16,REDACTED
1510860,1,3,3,0,0,3,REDACTED
1511662,1,13,18,7,14,39,REDACTED
1511662,2,2,7,1,9,17,REDACTED
1511662,3,2,4,5,11,20,REDACTED
1511764,1,6,6,3,9,18,REDACTED
1511764,2,7,6,4,4,14,REDACTED
1511996,1,6,6,8,4,18,REDACTED
1511996,2,6,12,3,0,15,REDACTED
1512746,1,4,4,4,3,11,REDACTED
1512746,2,7,13,0,3,16,REDACTED
1512746,3,10,11,10,0,21,REDACTED
1512746,4,0,0,0,0,0,REDACTED
1513075,1,13,6,0,0,6,REDACTED
1513075,2,6,8,23,2,33,REDACTED
1513345,2,2,2,0,0,2,REDACTED
1513384,1,3,3,4,5,12,REDACTED
1513384,2,2,2,4,0,6,REDACTED
1513384,3,4,9,19,7,35,REDACTED
1513522,1,5,6,2,10,18,REDACTED
1513559,1,7,6,0,3,9,REDACTED
1513559,2,5,4,9,6,19,REDACTED
1513559,4,4,5,7,3,15,REDACTED
1513686,1,16,25,7,14,46,REDACTED
1513686,2,5,1,4,1,6,REDACTED
1513686,3,6,3,3,10,16,REDACTED
1514353,1,2,2,7,10,19,REDACTED
1514353,2,4,6,3,0,9,REDACTED
1514353,3,4,0,12,0,12,REDACTED
1514353,4,4,13,8,0,21,REDACTED
1514387,1,2,2,0,0,2,REDACTED
1514387,2,0,11,0,0,11,REDACTED
1514387,3,4,4,0,0,4,REDACTED
1514387,4,4,0,0,0,0,REDACTED
1514671,1,8,10,5,7,22,REDACTED
1514816,1,4,1,7,2,10,REDACTED
1515640,1,2,2,5,5,12,REDACTED
1515640,2,4,5,7,4,16,REDACTED
1517055,1,9,10,11,13,34,REDACTED
1517055,2,6,1,9,9,19,REDACTED
1517305,1,6,7,15,9,31,REDACTED
1517305,2,3,2,8,0,10,REDACTED
1518236,1,8,12,0,3,15,REDACTED
1518236,2,8,9,10,5,24,REDACTED
1518644,1,4,2,4,6,12,REDACTED
1518677,1,4,4,4,0,8,REDACTED
1518677,2,0,0,0,0,0,REDACTED
1519302,1,6,9,7,0,16,REDACTED
1519405,1,18,12,0,0,12,REDACTED
1519405,2,2,3,0,0,3,REDACTED
1519528,1,4,4,10,0,14,REDACTED
1519528,2,2,12,2,0,14,REDACTED
1519634,1,2,2,5,0,7,REDACTED
1519839,1,1,3,17,7,27,REDACTED
1519839,2,0,4,8,6,18,REDACTED
1519923,1,15,12,11,20,43,REDACTED
1519923,2,5,4,2,4,10,REDACTED
1519923,3,6,4,5,2,11,REDACTED
1519923,4,5,6,5,3,14,REDACTED
1520106,1,4,3,7,0,10,REDACTED
1520581,1,2,1,7,8,16,REDACTED
1520581,2,2,2,3,8,13,REDACTED
1520682,1,9,8,0,0,8,REDACTED
1520801,1,8,9,0,0,9,REDACTED
1520801,2,7,7,0,0,7,REDACTED
1520801,3,7,5,0,0,5,REDACTED
1521032,1,9,7,2,0,9,REDACTED
1521032,2,3,3,2,1,6,REDACTED
1521110,1,13,10,0,6,16,REDACTED
1521128,1,3,9,2,0,11,REDACTED
1521128,2,2,2,2,0,4,REDACTED
1521281,1,4,4,6,0,10,REDACTED
1521954,1,7,10,7,2,19,REDACTED
1522391,1,4,4,10,5,19,REDACTED
1522391,2,0,0,2,0,2,REDACTED
1523030,1,4,4,10,2,16,REDACTED
1523030,2,8,6,7,5,18,REDACTED
1523397,1,4,4,3,4,11,REDACTED
1523397,2,6,7,3,5,15,REDACTED
1524172,1,3,3,8,0,11,REDACTED
1525172,1,4,7,9,6,22,REDACTED
1525645,1,7,9,2,15,26,REDACTED
1525645,2,11,11,9,13,33,REDACTED
1525645,3,2,2,6,2,10,REDACTED
1526058,1,6,6,7,7,20,REDACTED
1526367,1,8,8,1,13,22,REDACTED
1526367,2,6,8,1,13,22,REDACTED
1527001,1,0,0,0,0,0,REDACTED
1527001,2,4,2,5,4,11,REDACTED
1527259,1,6,11,9,1,21,REDACTED
1527282,1,5,5,0,7,12,REDACTED
1527282,2,6,6,0,3,9,REDACTED
1527456,1,1,1,8,4,13,REDACTED
1527456,2,2,1,2,0,3,REDACTED
1527855,1,7,5,6,0,11,REDACTED
1527855,2,9,10,8,0,18,REDACTED
1527855,3,3,10,1,0,11,REDACTED
1527884,1,13,15,15,12,42,REDACTED
1527884,2,6,7,10,8,25,REDACTED
1528566,1,5,7,0,4,11,REDACTED
1528566,2,5,6,3,5,14,REDACTED
1528566,3,2,4,7,6,17,REDACTED
1529010,1,2,0,4,5,9,REDACTED
1529010,2,0,0,0,0,0,REDACTED
1529010,3,0,0,3,0,3,REDACTED
1529010,4,2,0,9,0,9,REDACTED
1529010,5,0,0,0,0,0,REDACTED
1529066,1,3,5,6,5,16,REDACTED
1529066,2,3,3,5,6,14,REDACTED
1529149,1,9,11,13,5,29,REDACTED
1529149,2,2,6,8,6,20,REDACTED
1529263,1,9,12,0,0,12,REDACTED
1529263,2,2,3,0,0,3,REDACTED
1529383,1,2,4,5,4,13,REDACTED
1529807,1,3,6,2,6,14,REDACTED
1529807,2,7,7,4,5,16,REDACTED
1531455,1,6,9,4,7,20,REDACTED
1531455,2,3,3,1,3,7,REDACTED
1531455,3,2,2,3,10,15,REDACTED
1531620,1,10,15,6,6,27,REDACTED
1531759,1,6,6,6,3,15,REDACTED
1531759,2,4,4,1,0,5,REDACTED
1531759,3,1,2,6,3,11,REDACTED
1531759,4,10,11,8,4,23,REDACTED
1532555,1,4,4,2,8,14,REDACTED
1532555,2,0,0,0,0,0,REDACTED
1533517,1,2,4,0,0,4,REDACTED
1533517,2,6,5,2,0,7,REDACTED
1535155,1,9,11,10,5,26,REDACTED
1535360,1,7,2,5,0,7,REDACTED
1535360,2,2,2,5,0,7,REDACTED
1535360,3,8,9,0,0,9,REDACTED
1536335,1,10,10,0,8,18,REDACTED
1536972,1,3,3,2,4,9,REDACTED
1537237,1,13,10,10,4,24,REDACTED
1537445,1,10,11,5,4,20,REDACTED
1537445,2,0,0,0,0,0,REDACTED
1537664,1,6,6,5,3,14,REDACTED
1537690,1,0,0,8,0,8,REDACTED
1537690,2,3,3,5,4,12,REDACTED
1537761,1,5,8,9,11,28,REDACTED
1537808,1,0,0,0,13,13,REDACTED
1537808,2,0,0,0,12,12,REDACTED
1538437,1,8,9,6,7,22,REDACTED
1538437,2,8,7,5,7,19,REDACTED
1538822,1,12,12,5,9,26,REDACTED
1538822,2,6,7,11,0,18,REDACTED
1543946,1,18,15,0,0,15,REDACTED
1544286,1,9,11,14,13,38,REDACTED
1544286,2,9,8,2,2,12,REDACTED
1544286,3,7,8,6,9,23,REDACTED
1544286,4,6,8,0,13,21,REDACTED
1545052,1,11,11,9,0,20,REDACTED
1545052,2,8,6,0,0,6,REDACTED
1545052,3,5,5,0,0,5,REDACTED
1546411,1,2,2,4,2,8,REDACTED
1546411,2,2,2,3,6,11,REDACTED
1548042,1,8,12,7,3,22,REDACTED
1548042,2,3,4,9,0,13,REDACTED
1600763,1,2,3,3,5,11,REDACTED
1601161,1,3,4,3,11,18,REDACTED
1605527,1,6,8,0,0,8,REDACTED
1605599,1,9,12,7,4,23,REDACTED
1605599,2,2,3,13,4,20,REDACTED
1634500,1,8,8,8,15,31,REDACTED
1634651,1,12,12,3,7,22,REDACTED
1634651,2,10,10,4,2,16,REDACTED
1634651,3,19,0,0,0,0,REDACTED
1634937,1,0,0,2,1,3,REDACTED
1635428,1,8,5,3,7,15,REDACTED
1635428,2,14,14,12,12,38,REDACTED
1635458,1,4,5,6,0,11,REDACTED
1635486,1,8,8,10,3,21,REDACTED
1635486,2,6,4,0,0,4,REDACTED
1635851,1,6,2,17,7,26,REDACTED
1636178,1,8,6,3,12,21,REDACTED
1636178,2,12,12,11,7,30,REDACTED
1636735,1,12,2,2,18,22,REDACTED
1636867,1,6,2,0,0,2,REDACTED
1636883,1,10,4,2,9,15,REDACTED
1641419,1,3,3,4,5,12,REDACTED
1642037,1,14,20,23,5,48,REDACTED
1642168,1,17,15,6,11,32,REDACTED
1642168,2,4,4,4,5,13,REDACTED
1643997,1,7,8,11,12,31,REDACTED
1644379,1,8,9,4,10,23,REDACTED
1644379,2,6,6,9,8,23,REDACTED
1646072,1,6,10,8,13,31,REDACTED
1646072,2,7,7,3,10,20,REDACTED
1646187,1,6,6,2,7,15,REDACTED
1646324,1,6,6,7,6,19,REDACTED
1646324,2,2,3,0,11,14,REDACTED
1646393,1,4,5,5,6,16,REDACTED
1646393,2,2,3,0,4,7,REDACTED
1646661,1,6,5,4,5,14,REDACTED
1646661,2,4,4,2,2,8,REDACTED
1647261,1,6,3,8,1,12,REDACTED
1648486,1,2,1,2,4,7,REDACTED
1648486,2,5,7,6,7,20,REDACTED
1648715,1,3,3,6,13,22,REDACTED
1648715,2,3,3,6,2,11,REDACTED
1649183,1,10,15,13,0,28,REDACTED
1652411,1,7,8,9,12,29,REDACTED
1652411,2,4,5,14,5,24,REDACTED
1654187,1,9,7,4,0,11,REDACTED
1654187,2,4,5,13,0,18,REDACTED
1654636,1,7,4,5,3,12,REDACTED
1654978,1,8,11,4,0,15,REDACTED
1675112,1,3,4,3,2,9,REDACTED
1675112,2,3,10,4,8,22,REDACTED
1675112,3,2,2,8,3,13,REDACTED
1675112,4,2,5,2,0,7,REDACTED
1675337,1,2,2,4,3,9,REDACTED
1675405,1,10,10,0,0,10,REDACTED
1675642,1,5,9,2,5,16,REDACTED
1675642,2,7,7,2,13,22,REDACTED
1675642,3,6,6,13,7,26,REDACTED
1675642,4,2,2,3,2,7,REDACTED
1675702,1,11,14,0,11,25,REDACTED
1675810,1,8,3,3,3,9,REDACTED
1675810,2,8,10,9,12,31,REDACTED
1675891,1,2,2,5,2,9,REDACTED
1675891,2,6,4,12,3,19,REDACTED
1676022,1,0,0,2,3,5,REDACTED
1676022,2,3,3,2,2,7,REDACTED
1676299,1,3,6,6,0,12,REDACTED
1676299,2,2,6,1,0,7,REDACTED
1676299,3,0,0,10,2,12,REDACTED
1676609,1,8,8,7,0,15,REDACTED
1676609,2,7,11,5,21,37,REDACTED
1676640,1,3,3,4,6,13,REDACTED
1676760,1,4,12,12,13,37,REDACTED
1677209,1,4,0,0,0,0,REDACTED
1677209,2,7,8,0,7,15,REDACTED
1677209,3,0,0,0,0,0,REDACTED
1677209,4,4,7,6,4,17,REDACTED
1677373,1,14,22,25,26,73,REDACTED
1677373,2,4,6,5,5,16,REDACTED
1677381,1,2,3,6,5,14,REDACTED
1677381,2,4,4,4,4,12,REDACTED
1677424,1,4,10,3,1,14,REDACTED
1677424,2,9,3,0,5,8,REDACTED
1677424,3,12,13,8,6,27,REDACTED
1677467,1,2,2,3,5,10,REDACTED
1677469,1,12,16,0,0,16,REDACTED
1677469,2,10,7,6,7,20,REDACTED
1677603,1,3,7,3,0,10,REDACTED
1677603,2,3,5,0,2,7,REDACTED
1677603,3,2,6,0,0,6,REDACTED
1678288,1,7,10,4,6,20,REDACTED
1678319,1,13,16,18,16,50,REDACTED
1678319,2,9,13,8,5,26,REDACTED
1678548,1,4,5,12,0,17,REDACTED
1678548,2,6,11,9,2,22,REDACTED
1678628,1,6,7,0,6,13,REDACTED
1678628,3,0,0,4,3,7,REDACTED
1678628,4,8,11,13,6,30,REDACTED
1679249,1,7,1,0,0,1,REDACTED
1679249,2,0,7,10,10,27,REDACTED
1679249,3,5,6,8,0,14,REDACTED
1679251,1,11,11,7,3,21,REDACTED
1679251,2,12,12,9,8,29,REDACTED
1679352,1,6,2,3,0,5,REDACTED
1679352,2,11,13,12,7,32,REDACTED
1679624,1,8,9,10,20,39,REDACTED
1679624,2,0,0,0,0,0,REDACTED
1679732,1,7,10,12,4,26,REDACTED
1679732,2,6,1,2,2,5,REDACTED
1679914,1,5,6,0,2,8,REDACTED
1680468,1,5,8,8,0,16,REDACTED
1680468,2,4,4,2,1,7,REDACTED
1680679,1,2,2,2,0,4,REDACTED
1680679,2,2,2,1,1,4,REDACTED
1680751,1,8,8,1,4,13,REDACTED
1680751,2,8,10,17,13,40,REDACTED
1680751,3,9,9,0,0,9,REDACTED
1681459,1,12,19,17,0,36,REDACTED
1681459,2,7,15,17,0,32,REDACTED
1681459,3,0,0,0,0,0,REDACTED
1681459,4,0,0,0,0,0,REDACTED
1681860,1,0,0,0,7,7,REDACTED
1682859,1,4,4,3,6,13,REDACTED
1683097,1,3,9,0,9,18,REDACTED
1683097,2,0,0,0,2,2,REDACTED
1683160,1,6,1,12,6,19,REDACTED
1683160,2,4,8,2,0,10,REDACTED
1683583,1,5,22,16,4,42,REDACTED
1683583,2,7,12,0,4,16,REDACTED
1684249,1,7,8,9,8,25,REDACTED
1684249,2,10,11,10,12,33,REDACTED
1684560,1,4,0,0,0,0,REDACTED
1684560,2,4,5,11,5,21,REDACTED
1684560,3,4,3,1,0,4,REDACTED
1684560,4,11,0,0,0,0,REDACTED
1684560,5,6,6,8,9,23,REDACTED
1684637,1,6,6,2,17,25,REDACTED
1684637,2,15,10,9,3,22,REDACTED
1684666,1,13,12,12,12,36,REDACTED
1684666,2,11,13,9,4,26,REDACTED
1684737,1,8,10,9,0,19,REDACTED
1684737,2,0,2,9,0,11,REDACTED
1684737,3,0,1,6,7,14,REDACTED
1684737,4,2,1,5,2,8,REDACTED
1684737,5,2,2,0,10,12,REDACTED
1684737,6,4,4,5,0,9,REDACTED
1684737,7,4,6,9,0,15,REDACTED
1684808,1,2,6,5,5,16,REDACTED
1684808,2,2,5,6,5,16,REDACTED
1684946,1,0,0,0,7,7,REDACTED
1684946,2,9,0,5,9,14,REDACTED
1684946,3,0,0,0,0,0,REDACTED
1684946,4,5,0,4,8,12,REDACTED
1684946,5,3,0,6,9,15,REDACTED
1685065,1,6,7,7,0,14,REDACTED
1685832,1,10,6,8,5,19,REDACTED
1685832,2,3,3,4,3,10,REDACTED
1686056,1,7,5,9,5,19,REDACTED
1686056,2,0,0,0,0,0,REDACTED
1687014,1,5,5,3,0,8,REDACTED
1687014,2,2,3,10,2,15,REDACTED
1687279,1,8,3,10,0,13,REDACTED
1687430,1,6,8,0,0,8,REDACTED
1687769,1,7,0,0,0,0,REDACTED
1687769,2,9,9,4,3,16,REDACTED
1687769,3,4,4,6,2,12,REDACTED
1688439,1,6,1,0,5,6,REDACTED
1688439,2,4,6,12,8,26,REDACTED
1688512,1,5,5,8,9,22,REDACTED
1688512,2,4,3,5,16,24,REDACTED
1688654,1,10,7,5,12,24,REDACTED
1688654,2,10,6,6,8,20,REDACTED
1688881,1,6,6,11,3,20,REDACTED
1688949,1,0,0,5,0,5,REDACTED
1689250,1,11,12,0,0,12,REDACTED
1689250,2,1,18,0,0,18,REDACTED
1689250,3,2,4,0,0,4,REDACTED
1689508,1,3,3,0,2,5,REDACTED
1689508,2,8,10,15,8,33,REDACTED
1689638,1,4,6,0,0,6,REDACTED
1689638,2,0,2,0,0,2,REDACTED
1689782,1,2,2,2,0,4,REDACTED
1689993,1,2,3,2,0,5,REDACTED
1689993,2,4,3,2,0,5,REDACTED
1690037,1,11,11,9,0,20,REDACTED
1690037,2,4,4,0,0,4,REDACTED
1690037,3,5,6,0,0,6,REDACTED
1690037,4,4,4,2,0,6,REDACTED
1690037,5,2,3,0,0,3,REDACTED
1690615,1,4,5,7,4,16,REDACTED
1690615,2,6,4,1,4,9,REDACTED
1690633,1,7,4,0,0,4,REDACTED
1690633,2,6,12,12,0,24,REDACTED
1690891,1,10,13,11,10,34,REDACTED
1690948,1,3,2,3,0,5,REDACTED
1690948,2,2,1,8,4,13,REDACTED
1690974,1,4,4,8,2,14,REDACTED
1690974,2,2,2,6,3,11,REDACTED
1691222,1,2,7,1,0,8,REDACTED
1691222,2,4,0,0,0,0,REDACTED
1691222,3,3,2,0,0,2,REDACTED
1691334,1,11,15,17,0,32,REDACTED
1691380,1,8,8,5,8,21,REDACTED
1691380,2,10,10,13,11,34,REDACTED
1691829,1,9,11,6,14,31,REDACTED
1691829,2,3,3,6,10,19,REDACTED
1691829,3,3,3,5,17,25,REDACTED
1692064,1,2,3,20,9,32,REDACTED
1692064,2,2,3,2,9,14,REDACTED
1692386,1,13,14,6,0,20,REDACTED
1692386,2,6,0,4,0,4,REDACTED
1692386,3,4,4,1,2,7,REDACTED
1692386,4,15,10,4,0,14,REDACTED
1693156,1,2,4,6,4,14,REDACTED
1693156,2,4,4,2,2,8,REDACTED
1693168,1,0,0,0,3,3,REDACTED
1693168,2,13,14,0,0,14,REDACTED
1693996,1,4,3,5,2,10,REDACTED
1693996,2,9,8,12,2,22,REDACTED
1694090,1,7,6,15,10,31,REDACTED
1694283,1,4,7,16,9,32,REDACTED
1695328,1,4,4,5,4,13,REDACTED
1695328,2,4,4,2,5,11,REDACTED
1696048,1,2,2,7,5,14,REDACTED
1696048,2,6,5,7,2,14,REDACTED
1696493,1,2,2,7,6,15,REDACTED
1696493,2,2,3,7,6,16,REDACTED
1697454,1,5,6,2,2,10,REDACTED
1697502,1,11,12,1,8,21,REDACTED
1698427,1,2,2,0,0,2,REDACTED
1698427,2,0,0,0,0,0,REDACTED
1699060,1,10,10,6,0,16,REDACTED
1699060,2,17,14,6,0,20,REDACTED
1699060,3,10,14,0,0,14,REDACTED
1699149,1,9,8,9,4,21,REDACTED
1699149,2,0,0,0,0,0,REDACTED
1699149,3,2,2,2,3,7,REDACTED
1699217,1,5,5,4,8,17,REDACTED
1699217,2,5,5,4,2,11,REDACTED
1699217,3,7,7,0,3,10,REDACTED
1699366,1,6,4,2,11,17,REDACTED
1699366,2,6,6,2,4,12,REDACTED
1699586,1,4,2,0,0,2,REDACTED
1699908,1,6,12,5,6,23,REDACTED
1700777,1,6,6,5,6,17,REDACTED
1700777,2,6,6,8,5,19,REDACTED
1700785,1,13,10,16,0,26,REDACTED
1700785,2,6,6,27,1,34,REDACTED
1700785,3,10,15,0,0,15,REDACTED
1701046,1,15,13,17,13,43,REDACTED
1701046,2,6,7,8,12,27,REDACTED
1701046,3,10,11,13,12,36,REDACTED
1701187,1,0,0,0,0,0,REDACTED
1701275,1,6,4,0,3,7,REDACTED
1701275,2,7,11,16,5,32,REDACTED
1701303,1,2,2,3,9,14,REDACTED
1701303,2,11,11,6,15,32,REDACTED
1702771,1,0,0,0,0,0,REDACTED
1704095,1,6,9,12,12,33,REDACTED
1704095,2,2,2,2,7,11,REDACTED
1704317,1,18,20,1,0,21,REDACTED
1704675,1,5,4,0,0,4,REDACTED
1705184,1,2,10,10,3,23,REDACTED
1705184,2,4,10,10,3,23,REDACTED
1705458,1,3,3,2,7,12,REDACTED
1705458,2,5,7,8,4,19,REDACTED
1705458,3,0,0,0,0,0,REDACTED
1705458,4,5,7,4,0,11,REDACTED
1705458,5,4,0,0,0,0,REDACTED
1705519,1,2,2,6,2,10,REDACTED
1705519,2,9,14,6,3,23,REDACTED
1705626,1,10,13,0,0,13,REDACTED
1705626,2,7,1,0,0,1,REDACTED
1706031,1,0,2,6,11,19,REDACTED
1706031,2,9,3,8,6,17,REDACTED
1706031,3,5,7,4,4,15,REDACTED
1706031,4,11,10,3,3,16,REDACTED
1706238,1,0,0,0,5,5,REDACTED
1706238,2,0,0,0,11,11,REDACTED
1706992,1,5,7,10,14,31,REDACTED
1706992,2,13,6,7,9,22,REDACTED
1707483,1,3,4,0,0,4,REDACTED
1707483,2,6,2,0,0,2,REDACTED
1707501,1,6,7,8,5,20,REDACTED
1707501,2,2,2,2,3,7,REDACTED
1707555,1,0,0,18,16,34,REDACTED
1707555,2,0,1,6,6,13,REDACTED
1707555,5,0,0,0,0,0,REDACTED
1708455,1,5,5,2,8,15,REDACTED
1708455,2,0,0,2,8,10,REDACTED
1708455,3,3,5,2,8,15,REDACTED
1708499,2,6,6,5,10,21,REDACTED
1708844,1,6,7,0,0,7,REDACTED
1708844,2,5,3,0,0,3,REDACTED
1709013,1,13,16,14,13,43,REDACTED
1709013,2,7,6,0,0,6,REDACTED
1709183,1,14,15,10,11,36,REDACTED
1709183,2,13,13,11,11,35,REDACTED
1709307,1,13,15,3,3,21,REDACTED
1709307,2,0,0,0,0,0,REDACTED
1709916,1,4,1,0,0,1,REDACTED
1709916,2,7,6,7,2,15,REDACTED
1710214,1,6,2,0,4,6,REDACTED
1710214,2,4,10,2,9,21,REDACTED
1710433,1,10,9,0,8,17,REDACTED
1710671,1,7,7,2,0,9,REDACTED
1711282,1,4,9,4,4,17,REDACTED
1711282,2,8,20,0,7,27,REDACTED
1711962,1,2,2,7,10,19,REDACTED
1712703,1,6,3,4,4,11,REDACTED
1712703,2,7,8,11,16,35,REDACTED
1713667,1,5,6,3,0,9,REDACTED
1713667,2,4,4,14,0,18,REDACTED
1713667,3,5,5,0,0,5,REDACTED
1713709,1,5,7,0,0,7,REDACTED
1713709,2,17,16,0,0,16,REDACTED
1714143,1,7,15,7,0,22,REDACTED
1714143,2,7,19,11,0,30,REDACTED
1714556,1,5,5,5,4,14,REDACTED
1714556,2,0,3,0,0,3,REDACTED
1714556,3,0,0,0,0,0,REDACTED
1714556,4,0,0,0,0,0,REDACTED
1714687,1,0,0,1,0,1,REDACTED
1714687,2,2,2,0,0,2,REDACTED
1714687,3,3,4,5,0,9,REDACTED
1714816,1,10,13,15,2,30,REDACTED
1714816,2,6,12,15,8,35,REDACTED
1715544,1,4,5,13,1,19,REDACTED
1715544,2,4,1,0,0,1,REDACTED
1715544,3,2,4,2,0,6,REDACTED
1715544,4,0,4,0,0,4,REDACTED
1715593,1,5,6,4,9,19,REDACTED
1715619,1,9,10,23,8,41,REDACTED
1715632,1,7,9,0,8,17,REDACTED
1715632,2,9,2,0,0,2,REDACTED
1716600,1,3,3,1,6,10,REDACTED
1716600,2,6,4,2,17,23,REDACTED
1716600,3,4,8,4,4,16,REDACTED
1716600,4,3,3,0,0,3,REDACTED
1716890,1,9,1,2,0,3,REDACTED
1716890,2,2,2,8,4,14,REDACTED
1717144,1,6,6,8,8,22,REDACTED
1717144,2,6,6,11,2,19,REDACTED
1717144,3,6,6,3,0,9,REDACTED
1717144,4,13,15,10,0,25,REDACTED
1717144,5,6,6,2,5,13,REDACTED
1717144,6,6,6,4,12,22,REDACTED
1717144,7,6,6,6,0,12,REDACTED
1717684,1,5,6,4,18,28,REDACTED
1717684,2,4,8,2,9,19,REDACTED
1717961,1,11,14,30,0,44,REDACTED
1719347,1,6,3,4,1,8,REDACTED
1719347,2,6,7,5,0,12,REDACTED
1719658,1,6,2,2,0,4,REDACTED
1720106,1,0,0,0,0,0,REDACTED
1720106,2,8,5,3,3,11,REDACTED
1720168,1,10,12,12,0,24,REDACTED
1720168,2,13,12,6,0,18,REDACTED
1720817,1,3,3,2,0,5,REDACTED
1720817,2,7,8,4,0,12,REDACTED
1720853,1,2,8,10,5,23,REDACTED
1720853,2,0,0,5,3,8,REDACTED
1721088,1,3,3,4,0,7,REDACTED
1721088,2,3,6,7,0,13,REDACTED
1721170,1,6,7,6,10,23,REDACTED
1721170,2,4,8,16,11,35,REDACTED
1721170,3,3,6,0,3,9,REDACTED
1722680,1,10,11,9,11,31,REDACTED
1722680,2,6,8,5,4,17,REDACTED
1722680,3,6,8,5,5,18,REDACTED
1722680,4,10,9,6,4,19,REDACTED
1722971,1,9,11,21,3,35,REDACTED
1722971,2,0,0,21,4,25,REDACTED
1723134,1,0,0,13,12,25,REDACTED
1723134,2,7,8,6,5,19,REDACTED
1723228,1,9,4,4,4,12,REDACTED
1723531,1,2,2,2,2,6,REDACTED
1724307,1,0,1,0,0,1,REDACTED
1724307,2,3,11,10,8,29,REDACTED
1724307,4,4,11,1,2,14,REDACTED
1724515,1,0,0,0,0,0,REDACTED
1725195,1,5,1,4,11,16,REDACTED
1725195,2,7,10,2,4,16,REDACTED
1725617,1,0,0,0,0,0,REDACTED
1725617,2,8,2,0,0,2,REDACTED
1725838,1,6,8,14,6,28,REDACTED
1726579,1,3,5,3,3,11,REDACTED
1726579,2,11,7,19,21,47,REDACTED
1726675,1,2,5,3,0,8,REDACTED
1726675,2,4,5,4,0,9,REDACTED
1727085,1,0,0,0,0,0,REDACTED
1727085,2,0,0,0,0,0,REDACTED
1727250,1,0,0,1,4,5,REDACTED
1727250,2,4,2,5,8,15,REDACTED
1727250,3,2,7,15,7,29,REDACTED
1727500,1,0,0,6,4,10,REDACTED
1727500,2,0,0,4,0,4,REDACTED
1727551,1,8,7,0,0,7,REDACTED
1727673,1,8,12,10,10,32,REDACTED
1727673,2,6,9,11,0,20,REDACTED
1727673,3,2,1,3,4,8,REDACTED
1727678,1,3,7,9,0,16,REDACTED
1727678,2,3,4,0,2,6,REDACTED
1728072,1,2,2,4,7,13,REDACTED
1728072,2,3,3,2,6,11,REDACTED
1728072,3,4,4,2,2,8,REDACTED
1728108,1,3,3,16,0,19,REDACTED
1728108,2,10,11,3,4,18,REDACTED
1728229,1,4,6,3,4,13,REDACTED
1728229,2,5,5,8,13,26,REDACTED
1728988,1,10,8,13,7,28,REDACTED
1728988,2,6,8,3,12,23,REDACTED
1729093,1,7,11,6,2,19,REDACTED
1729093,2,3,7,8,3,18,REDACTED
1729994,1,8,8,5,2,15,REDACTED
1729994,2,8,8,1,5,14,REDACTED
1730044,1,2,3,0,0,3,REDACTED
1730044,2,6,7,0,0,7,REDACTED
1730044,3,6,7,0,0,7,REDACTED
1730044,4,8,9,0,0,9,REDACTED
1730146,1,2,4,2,5,11,REDACTED
1730146,2,0,0,0,0,0,REDACTED
1730404,1,10,11,7,22,40,REDACTED
1730469,1,9,8,8,0,16,REDACTED
1730469,2,7,3,10,0,13,REDACTED
1730743,1,7,9,10,3,22,REDACTED
1730743,2,4,5,16,3,24,REDACTED
1730822,1,10,10,11,12,33,REDACTED
1730822,2,1,28,22,2,52,REDACTED
1730836,1,8,8,2,7,17,REDACTED
1730836,2,12,10,1,5,16,REDACTED
1731036,1,10,13,28,7,48,REDACTED
1731190,1,4,3,0,0,3,REDACTED
1731307,1,4,6,4,5,15,REDACTED
1731307,2,4,7,8,5,20,REDACTED
1732218,1,9,5,1,1,7,REDACTED
1732218,2,10,10,3,1,14,REDACTED
1732227,1,21,15,16,11,42,REDACTED
1732523,1,3,3,0,1,4,REDACTED
1732583,1,2,2,2,0,4,REDACTED
1732583,2,2,2,2,0,4,REDACTED
1732710,1,11,9,3,2,14,REDACTED
1732722,1,0,0,0,0,0,REDACTED
1732899,1,6,8,11,3,22,REDACTED
1733548,1,8,8,3,1,12,REDACTED
1733548,2,3,3,6,2,11,REDACTED
1733915,1,14,18,7,6,31,REDACTED
1733915,2,10,15,8,7,30,REDACTED
1733952,1,17,17,5,5,27,REDACTED
1733952,2,6,19,4,7,30,REDACTED
1734216,1,2,2,1,4,7,REDACTED
1734216,2,3,3,4,3,10,REDACTED
1734603,1,10,11,7,7,25,REDACTED
1734603,2,7,9,10,11,30,REDACTED
1734603,3,4,7,7,12,26,REDACTED
1734606,1,5,7,11,8,26,REDACTED
1734621,1,5,8,4,9,21,REDACTED
1734621,2,3,3,1,5,9,REDACTED
1734621,3,12,11,0,2,13,REDACTED
1734652,1,2,2,3,3,8,REDACTED
1734657,1,13,20,12,15,47,REDACTED
1734657,2,13,5,12,13,30,REDACTED
1734787,2,2,3,5,5,13,REDACTED
1735115,1,0,0,1,0,1,REDACTED
1735812,1,8,8,20,11,39,REDACTED
1735812,2,6,7,16,9,32,REDACTED
1735812,3,5,6,2,0,8,REDACTED
1735812,4,6,7,9,1,17,REDACTED
1736316,1,0,0,2,6,8,REDACTED
1736316,2,2,1,0,3,4,REDACTED
1736316,3,15,17,6,4,27,REDACTED
1736492,1,8,11,0,0,11,REDACTED
1736695,1,11,1,0,0,1,REDACTED
1736942,1,9,15,11,18,44,REDACTED
1736942,2,9,13,13,8,34,REDACTED
1738463,1,2,2,17,0,19,REDACTED
1738463,2,2,7,6,2,15,REDACTED
1738808,2,6,7,15,2,24,REDACTED
1739070,1,17,13,4,11,28,REDACTED
1739347,1,6,4,2,2,8,REDACTED
1739347,2,4,4,0,0,4,REDACTED
1740585,1,3,10,0,6,16,REDACTED
1740585,2,3,7,0,8,15,REDACTED
1740789,1,4,4,3,4,11,REDACTED
1740878,1,4,4,6,6,16,REDACTED
1740930,1,8,8,7,13,28,REDACTED
1740930,2,6,21,3,5,29,REDACTED
1741523,1,2,2,0,8,10,REDACTED
1741523,2,6,11,0,5,16,REDACTED
1741546,1,6,6,0,0,6,REDACTED
1741546,2,0,7,0,0,7,REDACTED
1741741,1,17,20,5,2,27,REDACTED
1741741,2,11,22,2,2,26,REDACTED
1741741,3,0,0,0,0,0,REDACTED
1741799,1,4,5,11,2,18,REDACTED
1741799,2,2,3,11,2,16,REDACTED
1742107,1,8,12,7,4,23,REDACTED
1742107,2,11,15,9,9,33,REDACTED
1742204,1,2,2,6,4,12,REDACTED
1742204,2,5,6,5,4,15,REDACTED
1742204,3,5,4,0,10,14,REDACTED
1742349,1,6,9,8,10,27,REDACTED
1742349,2,2,5,0,6,11,REDACTED
1742526,1,13,14,10,3,27,REDACTED
1742526,2,4,4,3,0,7,REDACTED
1742583,1,5,5,3,5,13,REDACTED
1742583,2,4,4,2,6,12,REDACTED
1742831,1,2,2,0,0,2,REDACTED
1742831,2,0,0,0,0,0,REDACTED
1743251,1,2,1,1,1,3,REDACTED
1743251,2,7,7,6,3,16,REDACTED
1743251,3,4,4,0,2,6,REDACTED
1743363,1,2,1,9,2,12,REDACTED
1743363,2,7,2,3,6,11,REDACTED
1743369,1,0,0,4,11,15,REDACTED
1743369,3,2,4,5,0,9,REDACTED
1743491,1,5,4,9,6,19,REDACTED
1743491,2,2,2,4,3,9,REDACTED
1743886,1,4,4,4,4,12,REDACTED
1744305,1,8,12,7,1,20,REDACTED
1744305,2,7,1,0,0,1,REDACTED
1744305,3,7,5,5,7,17,REDACTED
1744327,1,19,6,8,4,18,REDACTED
1744327,2,6,5,8,12,25,REDACTED
1744573,1,9,11,8,15,34,REDACTED
1744573,2,5,4,7,16,27,REDACTED
1744670,1,8,10,18,4,32,REDACTED
1744670,2,3,4,0,11,15,REDACTED
1744743,1,5,3,2,1,6,REDACTED
1744743,2,9,11,14,6,31,REDACTED
1744743,3,7,7,19,16,42,REDACTED
1744743,4,0,0,12,4,16,REDACTED
1745197,1,7,8,7,2,17,REDACTED
1745197,2,12,9,9,4,22,REDACTED
1745399,1,0,0,0,0,0,REDACTED
1745399,2,0,0,0,0,0,REDACTED
1745494,1,8,9,8,16,33,REDACTED
1746215,1,9,11,0,0,11,REDACTED
1746215,2,4,3,0,0,3,REDACTED
1746831,1,5,7,9,7,23,REDACTED
1746831,2,0,1,12,9,22,REDACTED
1747079,1,0,0,0,0,0,REDACTED
1747079,2,9,12,0,0,12,REDACTED
1747079,3,0,0,0,0,0,REDACTED
1747556,1,4,7,8,13,28,REDACTED
1747562,1,11,12,15,4,31,REDACTED
1747562,2,9,7,7,0,14,REDACTED
1747562,3,4,4,8,2,14,REDACTED
1748481,1,10,10,14,0,24,REDACTED
1748481,2,4,2,2,0,4,REDACTED
1748552,1,8,8,0,2,10,REDACTED
1748552,2,6,2,4,2,8,REDACTED
1748949,1,10,11,2,6,19,REDACTED
1748964,1,3,3,2,2,7,REDACTED
1748964,2,5,5,3,12,20,REDACTED
1748964,3,0,0,3,7,10,REDACTED
1748996,1,13,15,9,11,35,REDACTED
1748996,2,3,0,0,4,4,REDACTED
1748996,3,2,2,0,4,6,REDACTED
1750710,1,3,9,0,0,9,REDACTED
1750710,2,4,11,0,0,11,REDACTED
1750710,3,0,0,0,0,0,REDACTED
1751114,1,4,0,0,0,0,REDACTED
1751114,2,3,4,7,3,14,REDACTED
1751114,3,2,2,2,0,4,REDACTED
1751194,1,12,3,9,9,21,REDACTED
1751340,1,15,14,8,4,26,REDACTED
1751340,3,7,8,13,3,24,REDACTED
1751703,1,4,2,6,4,12,REDACTED
1751703,2,2,3,0,8,11,REDACTED
1751732,1,6,8,5,0,13,REDACTED
1751732,2,6,4,5,6,15,REDACTED
1751732,3,8,10,0,0,10,REDACTED
1751980,1,5,9,19,4,32,REDACTED
1751980,2,11,13,4,4,21,REDACTED
1752133,1,7,9,8,5,22,REDACTED
1752133,2,2,3,9,6,18,REDACTED
1752192,1,1,14,9,0,23,REDACTED
1752192,2,1,5,10,8,23,REDACTED
1752628,1,4,7,0,2,9,REDACTED
1752923,1,6,15,8,10,33,REDACTED
1752923,2,0,0,9,13,22,REDACTED
1752923,3,10,14,21,9,44,REDACTED
1753343,1,0,0,2,2,4,REDACTED
1753402,1,0,0,2,0,2,REDACTED
1753402,2,2,2,7,2,11,REDACTED
1753402,4,2,2,11,2,15,REDACTED
1753969,1,3,3,4,2,9,REDACTED
1753969,2,13,14,0,0,14,REDACTED
1753969,3,13,14,5,0,19,REDACTED
1754866,1,0,11,11,7,29,REDACTED
1754866,2,2,6,2,6,14,REDACTED
1754866,3,2,7,2,5,14,REDACTED
1754929,1,4,5,2,6,13,REDACTED
1754929,2,4,1,0,6,7,REDACTED
1755078,1,0,0,0,0,0,REDACTED
1755078,2,8,10,7,9,26,REDACTED
1755078,3,5,3,4,9,16,REDACTED
1755078,4,5,8,7,28,43,REDACTED
1755199,1,7,7,5,12,24,REDACTED
1755199,2,6,5,5,7,17,REDACTED
1755570,1,0,0,0,0,0,REDACTED
1755570,2,4,12,9,0,21,REDACTED
1755869,1,6,6,8,4,18,REDACTED
1756361,1,2,2,3,9,14,REDACTED
1756361,2,0,0,0,0,0,REDACTED
1756384,1,14,28,2,10,40,REDACTED
1756384,2,5,3,6,1,10,REDACTED
1756384,3,6,0,0,0,0,REDACTED
1756488,1,9,9,3,7,19,REDACTED
1756488,2,12,19,3,6,28,REDACTED
1757022,1,7,7,2,2,11,REDACTED
1757022,2,6,4,4,0,8,REDACTED
1757278,1,9,9,10,18,37,REDACTED
1757462,1,6,6,12,2,20,REDACTED
1757462,2,2,9,0,0,9,REDACTED
1757701,1,6,16,8,1,25,REDACTED
1758062,1,0,0,0,0,0,REDACTED
1758296,1,0,0,3,4,7,REDACTED
1758296,2,6,10,3,0,13,REDACTED
1758542,1,9,11,8,7,26,REDACTED
1758542,2,3,4,2,6,12,REDACTED
1758542,3,0,0,3,0,3,REDACTED
1758899,1,8,10,16,14,40,REDACTED
1758899,2,5,5,22,15,42,REDACTED
1759621,1,0,0,0,0,0,REDACTED
1759621,2,7,10,0,6,16,REDACTED
1759821,1,2,2,0,0,2,REDACTED
1759821,2,6,1,2,1,4,REDACTED
1759906,1,2,2,0,2,4,REDACTED
1760113,1,2,28,14,0,42,REDACTED
1760113,2,0,0,0,0,0,REDACTED
1760140,1,6,1,4,3,8,REDACTED
1760140,2,0,0,0,0,0,REDACTED
1760178,1,5,9,8,0,17,REDACTED
1760178,2,4,2,2,0,4,REDACTED
1760804,1,0,0,0,0,0,REDACTED
1760804,2,0,0,0,0,0,REDACTED
1760965,1,5,7,12,3,22,REDACTED
1761035,1,2,2,4,0,6,REDACTED
1761035,2,0,0,4,9,13,REDACTED
1761307,1,6,6,4,3,13,REDACTED
1761307,2,2,2,1,8,11,REDACTED
1761539,1,8,8,6,10,24,REDACTED
1761539,2,8,8,4,4,16,REDACTED
1761539,3,12,1,16,12,29,REDACTED
1761781,1,5,4,1,1,6,REDACTED
1761961,1,13,18,2,14,34,REDACTED
1761961,3,2,2,3,12,17,REDACTED
1761961,4,3,6,5,3,14,REDACTED
1762523,1,6,6,8,6,20,REDACTED
1762605,1,13,14,6,5,25,REDACTED
1762605,2,6,9,3,2,14,REDACTED
1762605,3,8,14,43,14,71,REDACTED
1763295,1,4,10,0,0,10,REDACTED
1763295,2,0,9,0,0,9,REDACTED
1763371,1,18,11,0,18,29,REDACTED
1763371,2,18,11,0,7,18,REDACTED
1763564,1,2,2,3,2,7,REDACTED
1763564,2,3,3,5,3,11,REDACTED
1763564,3,2,2,2,3,7,REDACTED
1763738,1,4,4,1,0,5,REDACTED
1763738,2,5,11,2,0,13,REDACTED
1763771,1,5,14,8,12,34,REDACTED
1763771,2,5,11,9,6,26,REDACTED
1763822,1,6,5,9,5,19,REDACTED
1763822,2,8,9,16,0,25,REDACTED
1763822,3,8,10,21,10,41,REDACTED
1763822,4,4,6,18,15,39,REDACTED
1763822,5,6,1,4,0,5,REDACTED
1764022,1,4,2,3,4,9,REDACTED
1764197,1,4,5,7,9,21,REDACTED
1764197,2,4,4,2,9,15,REDACTED
1764197,3,0,0,2,0,2,REDACTED
1764197,4,0,15,6,0,21,REDACTED
1764408,1,0,0,3,1,4,REDACTED
1764408,2,3,3,1,7,11,REDACTED
1764458,1,4,5,8,0,13,REDACTED
1764458,2,0,4,0,0,4,REDACTED
1764458,3,0,3,0,0,3,REDACTED
1764545,1,23,23,14,12,49,REDACTED
1764545,2,3,3,2,6,11,REDACTED
1764809,1,10,11,4,5,20,REDACTED
1765157,1,6,7,3,1,11,REDACTED
1765157,2,5,7,3,0,10,REDACTED
1765157,3,12,15,9,5,29,REDACTED
1765518,1,12,15,9,3,27,REDACTED
1765518,2,4,3,1,0,4,REDACTED
1765859,1,4,10,1,3,14,REDACTED
1765859,2,6,7,4,6,17,REDACTED
1765859,3,0,5,8,5,18,REDACTED
1766068,1,3,2,5,0,7,REDACTED
1766503,1,2,17,13,3,33,REDACTED
1766759,1,6,4,4,3,11,REDACTED
1766759,2,8,6,9,12,27,REDACTED
1767028,1,3,3,10,13,26,REDACTED
1767028,2,0,0,7,9,16,REDACTED
1767914,1,0,0,0,0,0,REDACTED
1767914,2,2,2,16,0,18,REDACTED
1767914,3,6,6,8,6,20,REDACTED
1768130,1,0,0,4,3,7,REDACTED
1768130,2,0,0,0,0,0,REDACTED
1768582,1,3,3,0,0,3,REDACTED
1768718,1,9,10,4,4,18,REDACTED
1768718,2,0,2,0,1,3,REDACTED
1768718,3,5,2,0,5,7,REDACTED
1768718,4,0,0,0,0,0,REDACTED
1769154,1,1,1,9,2,12,REDACTED
1769154,2,9,8,0,0,8,REDACTED
1769154,3,2,13,9,0,22,REDACTED
1769165,1,8,9,5,11,25,REDACTED
1769251,1,6,3,5,7,15,REDACTED
1769567,1,2,1,14,9,24,REDACTED
1769567,2,5,9,0,2,11,REDACTED
1769567,4,7,9,10,18,37,REDACTED
1769567,5,8,14,9,12,35,REDACTED
1769567,6,4,9,0,0,9,REDACTED
1769580,1,4,6,5,8,19,REDACTED
1769580,2,9,7,4,13,24,REDACTED
1769580,3,3,5,2,3,10,REDACTED
1769938,1,9,6,0,0,6,REDACTED
1769938,2,4,4,0,0,4,REDACTED
1769980,1,8,7,4,4,15,REDACTED
1770374,1,0,0,0,0,0,REDACTED
1770595,1,4,5,11,9,25,REDACTED
1770595,2,9,9,2,2,13,REDACTED
1770595,3,7,6,9,13,28,REDACTED
1770757,1,8,12,5,0,17,REDACTED
1770757,2,0,0,4,0,4,REDACTED
1771111,1,0,14,11,0,25,REDACTED
1771111,2,9,11,10,7,28,REDACTED
1771118,1,12,18,6,10,34,REDACTED
1771118,2,8,9,10,5,24,REDACTED
1771501,1,4,7,6,11,24,REDACTED
1771501,2,3,5,7,2,14,REDACTED
1771501,3,2,2,5,0,7,REDACTED
1771501,4,11,11,8,3,22,REDACTED
1771922,1,2,4,0,2,6,REDACTED
1771922,2,0,3,9,8,20,REDACTED
1772046,1,6,10,4,1,15,REDACTED
1772046,2,3,6,1,0,7,REDACTED
1772046,3,0,0,0,0,0,REDACTED
1772050,1,8,5,6,7,18,REDACTED
1772050,2,12,17,21,5,43,REDACTED
1772050,4,6,12,2,0,14,REDACTED
1772290,1,14,14,0,14,28,REDACTED
1772290,2,2,3,2,10,15,REDACTED
1772923,1,6,7,3,1,11,REDACTED
1772923,2,10,10,8,8,26,REDACTED
1773097,1,0,0,4,7,11,REDACTED
1773247,1,5,5,6,6,17,REDACTED
1773375,1,3,8,8,7,23,REDACTED
1773375,2,2,6,6,4,16,REDACTED
1773411,1,6,3,1,2,6,REDACTED
1773411,2,8,9,16,4,29,REDACTED
1773423,1,6,7,2,9,18,REDACTED
1773703,1,12,14,8,13,35,REDACTED
1773703,2,3,3,8,10,21,REDACTED
1774345,1,0,0,0,0,0,REDACTED
1774345,2,0,0,0,0,0,REDACTED
1774345,3,0,0,0,0,0,REDACTED
1774345,4,0,0,0,0,0,REDACTED
1774345,7,0,0,0,0,0,REDACTED
1774345,8,0,0,0,0,0,REDACTED
1774421,1,0,0,0,0,0,REDACTED
1774421,2,0,0,0,0,0,REDACTED
1774421,3,0,0,0,0,0,REDACTED
1775387,1,2,2,2,3,7,REDACTED
1775387,2,4,2,3,5,10,REDACTED
1775387,3,4,2,2,3,7,REDACTED
1775486,1,6,2,3,5,10,REDACTED
1775486,2,6,6,4,6,16,REDACTED
1775551,1,7,4,16,6,26,REDACTED
1775551,2,12,11,14,0,25,REDACTED
1775999,1,14,15,8,10,33,REDACTED
1775999,2,10,10,11,10,31,REDACTED
1776317,1,4,6,7,5,18,REDACTED
1777223,1,5,6,8,0,14,REDACTED
1777223,2,0,0,0,0,0,REDACTED
1777291,1,2,4,3,2,9,REDACTED
1777291,2,2,4,3,4,11,REDACTED
1777291,3,0,2,0,3,5,REDACTED
1777291,4,2,4,9,0,13,REDACTED
1777740,1,0,0,0,0,0,REDACTED
1777740,2,0,0,0,0,0,REDACTED
1777740,3,0,0,0,0,0,REDACTED
1777834,1,5,5,0,0,5,REDACTED
1777834,2,16,13,3,0,16,REDACTED
1777834,3,3,13,4,18,35,REDACTED
1778084,1,9,14,11,3,28,REDACTED
1778084,2,3,8,11,0,19,REDACTED
1778087,1,5,8,0,7,15,REDACTED
1780209,1,0,0,0,0,0,REDACTED
1780209,2,0,0,0,0,0,REDACTED
1783124,1,7,7,2,3,12,REDACTED
1783124,2,7,7,8,2,17,REDACTED
1783214,1,2,1,1,5,7,REDACTED
1783214,2,8,2,4,7,13,REDACTED
1783214,3,3,1,8,10,19,REDACTED
1783241,1,2,2,0,5,7,REDACTED
1783304,1,4,4,3,0,7,REDACTED
1783534,1,8,8,4,5,17,REDACTED
1783578,1,13,12,15,11,38,REDACTED
1783578,2,6,7,6,8,21,REDACTED
1783647,1,4,3,4,7,14,REDACTED
1783647,2,0,0,2,3,5,REDACTED
1784066,1,17,17,9,8,34,REDACTED
1784066,2,4,2,5,9,16,REDACTED
1784070,1,11,1,1,2,4,REDACTED
1784577,1,3,3,3,2,8,REDACTED
1784577,2,6,6,7,6,19,REDACTED
1785138,1,6,4,5,6,15,REDACTED
1785734,1,9,9,0,8,17,REDACTED
1786231,1,5,5,6,2,13,REDACTED
1786259,1,1,9,8,8,25,REDACTED
1786259,2,2,3,5,4,12,REDACTED
1786732,1,4,1,1,4,6,REDACTED
1786732,2,0,0,0,0,0,REDACTED
1786732,3,0,0,0,0,0,REDACTED
1786732,4,0,0,0,0,0,REDACTED
1786732,5,0,0,0,0,0,REDACTED
1787004,1,8,9,10,5,24,REDACTED
1787004,2,5,5,6,2,13,REDACTED
1787994,1,0,0,0,0,0,REDACTED
1787994,2,0,0,0,3,3,REDACTED
1787994,3,0,0,0,0,0,REDACTED
1788028,1,0,0,0,3,3,REDACTED
1788028,2,3,4,5,6,15,REDACTED
1788028,3,6,13,9,0,22,REDACTED
1788028,4,2,1,5,3,9,REDACTED
1788028,5,2,17,7,23,47,REDACTED
1788230,1,9,14,16,2,32,REDACTED
1788695,1,2,3,2,0,5,REDACTED
1789086,1,6,6,10,9,25,REDACTED
1789086,2,0,0,7,0,7,REDACTED
1789764,1,2,2,0,2,4,REDACTED
1789764,2,2,3,0,6,9,REDACTED
1790388,1,5,6,2,10,18,REDACTED
1790388,2,7,9,11,15,35,REDACTED
1791018,1,5,9,6,13,28,REDACTED
1791018,2,3,5,2,0,7,REDACTED
1791018,3,4,6,6,2,14,REDACTED
1791671,1,4,3,6,3,12,REDACTED
1791915,1,5,3,5,5,13,REDACTED
1791915,2,12,7,0,14,21,REDACTED
1792063,1,4,1,0,0,1,REDACTED
1792063,2,0,0,0,0,0,REDACTED
1792063,3,0,5,8,0,13,REDACTED
1792063,4,0,1,0,0,1,REDACTED
1792268,1,7,7,0,0,7,REDACTED
1792268,2,2,3,7,0,10,REDACTED
1792492,1,4,8,10,2,20,REDACTED
1792738,1,2,3,2,3,8,REDACTED
1794619,1,6,8,13,10,31,REDACTED
1794619,2,3,4,5,13,22,REDACTED
1794696,1,3,12,5,2,19,REDACTED
1794696,2,1,9,5,2,16,REDACTED
1794696,3,4,7,2,6,15,REDACTED
1795294,1,4,6,7,3,16,REDACTED
1795294,2,9,9,16,10,35,REDACTED
1795444,1,12,16,15,8,39,REDACTED
1795444,2,2,3,13,11,27,REDACTED
1795610,1,2,2,5,0,7,REDACTED
1795610,2,2,2,0,0,2,REDACTED
1795969,1,11,9,0,0,9,REDACTED
1796730,1,3,3,10,5,18,REDACTED
1796730,2,3,3,8,6,17,REDACTED
1796843,1,7,8,6,5,19,REDACTED
1796843,2,4,4,5,0,9,REDACTED
1797074,3,0,0,0,0,0,REDACTED
1797398,1,0,0,6,20,26,REDACTED
1797398,2,2,15,11,2,28,REDACTED
1798838,1,4,2,9,13,24,REDACTED
1798838,2,2,5,5,15,25,REDACTED
1798838,3,3,4,8,5,17,REDACTED
1799359,1,20,15,17,0,32,REDACTED
1799359,2,7,4,6,3,13,REDACTED
1800633,1,7,7,9,10,26,REDACTED
1800633,2,9,9,9,0,18,REDACTED
1800923,1,2,1,0,0,1,REDACTED
1800923,2,5,8,0,0,8,REDACTED
1800923,3,6,10,0,0,10,REDACTED
1801053,1,2,7,2,5,14,REDACTED
1801053,2,0,0,4,12,16,REDACTED
1801610,1,5,11,2,5,18,REDACTED
1801610,2,5,10,0,5,15,REDACTED
1801755,1,6,8,0,0,8,REDACTED
1801755,2,0,0,0,0,0,REDACTED
1801802,1,9,4,6,0,10,REDACTED
1801802,2,5,7,5,0,12,REDACTED
1801859,1,0,2,4,0,6,REDACTED
1801859,2,2,2,0,0,2,REDACTED
1802077,1,6,4,3,2,9,REDACTED
1802077,2,17,15,24,22,61,REDACTED
1802077,3,2,10,6,8,24,REDACTED
1802085,1,7,15,1,2,18,REDACTED
1802085,2,4,3,0,0,3,REDACTED
1802085,3,0,0,0,0,0,REDACTED
1802597,1,9,9,10,19,38,REDACTED
1802597,2,4,4,4,7,15,REDACTED
1803015,1,3,3,10,0,13,REDACTED
1803015,2,2,7,0,0,7,REDACTED
1803141,1,5,5,4,9,18,REDACTED
1803141,2,0,0,5,2,7,REDACTED
1803457,1,16,20,10,6,36,REDACTED
1803457,2,10,13,10,6,29,REDACTED
1803629,1,4,4,3,4,11,REDACTED
1803629,2,5,6,4,7,17,REDACTED
1803744,1,6,5,0,0,5,REDACTED
1803744,2,0,0,0,0,0,REDACTED
1803744,3,2,10,2,11,23,REDACTED
1804207,1,6,1,0,7,8,REDACTED
1804207,2,8,4,12,10,26,REDACTED
1804207,3,0,3,4,0,7,REDACTED
1804207,4,0,0,0,4,4,REDACTED
1804916,1,7,7,0,3,10,REDACTED
1804916,2,7,7,0,0,7,REDACTED
1804980,1,7,9,0,0,9,REDACTED
1804980,2,4,4,0,0,4,REDACTED
1805277,1,11,10,8,4,22,REDACTED
1805277,2,7,7,16,6,29,REDACTED
1805277,3,7,10,10,7,27,REDACTED
1805302,1,2,2,3,3,8,REDACTED
1805302,2,8,8,1,2,11,REDACTED
1805302,3,4,6,5,0,11,REDACTED
1805302,4,11,16,6,11,33,REDACTED
1805598,1,4,4,1,2,7,REDACTED
1805598,2,2,2,5,1,8,REDACTED
1805893,1,4,5,10,13,28,REDACTED
1805893,2,3,2,5,8,15,REDACTED
1805963,1,5,5,2,3,10,REDACTED
1806240,1,6,9,5,7,21,REDACTED
1806240,2,5,9,2,4,15,REDACTED
1806240,3,3,6,5,7,18,REDACTED
1807129,1,6,6,7,6,19,REDACTED
1807160,1,3,4,2,9,15,REDACTED
1807160,2,0,0,2,2,4,REDACTED
1807712,1,5,4,7,1,12,REDACTED
1807929,1,2,2,3,2,7,REDACTED
1807929,2,8,15,9,5,29,REDACTED
1807929,3,6,11,0,0,11,REDACTED
1807933,1,4,10,7,8,25,REDACTED
1807933,2,2,3,0,0,3,REDACTED
1808824,1,3,3,2,3,8,REDACTED
1808824,2,0,0,0,0,0,REDACTED
1809226,1,2,6,0,2,8,REDACTED
1809226,2,8,17,0,0,17,REDACTED
1809226,3,6,11,0,0,11,REDACTED
1810301,1,7,8,0,4,12,REDACTED
1810301,2,7,7,8,6,21,REDACTED
1810301,3,5,6,0,3,9,REDACTED
1810330,1,4,5,3,7,15,REDACTED
1811061,1,8,9,0,0,9,REDACTED
1811061,2,5,3,2,6,11,REDACTED
1811113,1,2,3,3,0,6,REDACTED
1811113,2,2,1,0,1,2,REDACTED
1811113,3,0,0,3,3,6,REDACTED
1811113,4,14,22,3,0,25,REDACTED
1811148,1,6,3,7,4,14,REDACTED
1811148,2,7,6,0,3,9,REDACTED
1811718,1,7,6,0,8,14,REDACTED
1811718,2,3,3,0,6,9,REDACTED
1812024,1,8,9,4,6,19,REDACTED
1812024,2,3,4,0,5,9,REDACTED
1812433,1,2,9,13,9,31,REDACTED
1812433,2,2,5,7,9,21,REDACTED
1812599,1,4,6,9,13,28,REDACTED
1812599,2,2,6,11,27,44,REDACTED
1812599,3,6,5,0,0,5,REDACTED
1812930,1,3,7,1,0,8,REDACTED
1812930,2,3,1,2,3,6,REDACTED
1813234,1,5,5,7,11,23,REDACTED
1813234,2,5,6,10,8,24,REDACTED
1814896,1,3,9,5,1,15,REDACTED
1814896,2,3,9,0,3,12,REDACTED
1814896,3,7,9,8,0,17,REDACTED
1815065,1,14,15,9,4,28,REDACTED
1815065,2,13,13,20,14,47,REDACTED
1815644,1,15,19,16,17,52,REDACTED
1816383,1,3,3,6,0,9,REDACTED
1816493,1,4,5,0,0,5,REDACTED
1816493,2,2,3,0,0,3,REDACTED
1817833,1,2,9,3,6,18,REDACTED
1818443,1,8,10,3,5,18,REDACTED
1818443,2,9,0,5,9,14,REDACTED
1818443,3,3,6,4,6,16,REDACTED
1818630,1,0,0,0,2,2,REDACTED
1818630,2,0,0,0,2,2,REDACTED
1818829,1,3,2,0,0,2,REDACTED
1818876,1,4,6,11,7,24,REDACTED
1818876,2,6,6,8,4,18,REDACTED
1819093,1,3,6,6,11,23,REDACTED
1819093,2,5,5,0,6,11,REDACTED
1819392,1,7,5,3,0,8,REDACTED
1819392,2,10,17,10,5,32,REDACTED
1819392,5,0,0,9,0,9,REDACTED
1819599,1,0,24,14,11,49,REDACTED
1819599,2,6,7,5,5,17,REDACTED
1820297,1,7,10,1,0,11,REDACTED
1820297,2,5,5,5,0,10,REDACTED
1820338,1,2,2,0,0,2,REDACTED
1820338,2,3,26,7,11,44,REDACTED
1820817,1,11,20,10,12,42,REDACTED
1820817,2,6,9,11,7,27,REDACTED
1820912,1,4,6,9,8,23,REDACTED
1820912,2,2,12,18,10,40,REDACTED
1821234,1,10,14,0,0,14,REDACTED
1821234,2,11,0,0,0,0,REDACTED
1821234,3,4,5,0,0,5,REDACTED
1821311,1,3,0,0,1,1,REDACTED
1821311,2,6,6,4,4,14,REDACTED
1821311,3,4,4,0,4,8,REDACTED
1821311,4,2,5,0,2,7,REDACTED
1822265,1,5,2,7,4,13,REDACTED
1822265,2,3,3,2,9,14,REDACTED
1822816,1,5,6,13,9,28,REDACTED
1822816,2,6,5,7,8,20,REDACTED
1822931,1,9,5,6,4,15,REDACTED
1822931,2,7,3,5,3,11,REDACTED
1823822,1,9,11,12,3,26,REDACTED
1823822,2,8,8,2,1,11,REDACTED
1823974,1,7,8,6,7,21,REDACTED
1824049,1,11,13,9,9,31,REDACTED
1824049,2,5,13,6,1,20,REDACTED
1824049,3,9,0,0,1,1,REDACTED
1824049,4,6,10,12,8,30,REDACTED
1824155,1,7,9,5,6,20,REDACTED
1824155,2,5,5,3,3,11,REDACTED
1824241,1,9,10,8,7,25,REDACTED
1824241,2,4,6,6,6,18,REDACTED
1824346,1,4,5,8,16,29,REDACTED
1824346,2,8,8,3,13,24,REDACTED
1824994,1,7,15,2,6,23,REDACTED
1824994,2,2,2,21,5,28,REDACTED
1825233,1,6,6,4,0,10,REDACTED
1825966,1,0,0,0,0,0,REDACTED
1825966,2,3,4,0,0,4,REDACTED
1826338,1,2,3,11,12,26,REDACTED
1826338,2,2,3,4,9,16,REDACTED
1826774,1,3,3,4,2,9,REDACTED
1827459,1,3,3,11,4,18,REDACTED
1829150,1,6,13,0,0,13,REDACTED
1829150,2,10,19,15,7,41,REDACTED
1829150,3,4,2,3,2,7,REDACTED
1831028,1,2,3,2,1,6,REDACTED
1831028,2,4,6,3,3,12,REDACTED
1831219,1,2,2,10,7,19,REDACTED
1831219,2,4,4,5,3,12,REDACTED
1831736,1,2,7,3,8,18,REDACTED
1831736,2,4,5,7,9,21,REDACTED
1832032,1,14,17,11,10,38,REDACTED
1832032,2,2,2,3,10,15,REDACTED
1832032,3,12,13,2,2,17,REDACTED
1832087,1,7,7,7,11,25,REDACTED
1832087,2,5,5,6,12,23,REDACTED
1832087,3,5,7,9,4,20,REDACTED
1832190,1,4,4,5,3,12,REDACTED
1832410,1,5,5,4,0,9,REDACTED
1832668,1,14,13,11,11,35,REDACTED
1832668,2,3,4,6,2,12,REDACTED
1832669,1,6,6,3,3,12,REDACTED
1832669,2,0,0,0,0,0,REDACTED
1832669,3,6,6,5,0,11,REDACTED
1832890,1,8,8,5,8,21,REDACTED
1832890,2,2,2,2,3,7,REDACTED
1833487,1,3,4,6,3,13,REDACTED
1833487,2,5,10,8,4,22,REDACTED
1833804,1,13,13,10,7,30,REDACTED
1833804,2,8,8,11,7,26,REDACTED
1833804,3,2,3,0,5,8,REDACTED
1834630,1,4,4,3,2,9,REDACTED
1834630,2,2,4,5,0,9,REDACTED
1835101,1,3,2,2,3,7,REDACTED
1835107,1,3,3,6,3,12,REDACTED
1835107,2,0,0,0,0,0,REDACTED
1835107,3,9,12,10,0,22,REDACTED
1835230,1,5,6,6,9,21,REDACTED
1835230,3,10,2,4,12,18,REDACTED
1835872,2,0,0,0,0,0,REDACTED
1836175,1,0,0,5,0,5,REDACTED
1836175,2,0,0,0,0,0,REDACTED
1836603,1,5,5,6,3,14,REDACTED
1836603,2,0,0,0,7,7,REDACTED
1836678,1,3,1,0,11,12,REDACTED
1836678,2,9,10,2,4,16,REDACTED
1836898,1,0,0,4,7,11,REDACTED
1837121,1,3,4,5,7,16,REDACTED
1837121,2,3,3,5,8,16,REDACTED
1837364,1,9,9,0,0,9,REDACTED
1837364,2,9,10,0,0,10,REDACTED
1838355,1,7,10,0,0,10,REDACTED
1838355,2,0,0,0,0,0,REDACTED
1838666,1,0,0,0,0,0,REDACTED
1838819,1,10,13,6,6,25,REDACTED
1838819,2,4,4,3,2,9,REDACTED
1839114,1,3,3,0,3,6,REDACTED
1839114,2,3,3,5,5,13,REDACTED
1839389,1,4,4,3,11,18,REDACTED
1839389,2,3,1,4,2,7,REDACTED
1840179,1,0,0,5,4,9,REDACTED
1840179,2,0,0,1,4,5,REDACTED
1840740,1,5,12,14,5,31,REDACTED
1840740,2,7,8,12,6,26,REDACTED
1840740,3,3,34,4,7,45,REDACTED
1840850,1,3,9,9,2,20,REDACTED
1840850,2,3,1,1,0,2,REDACTED
1841188,1,2,3,4,5,12,REDACTED
1842745,1,9,5,10,1,16,REDACTED
1842745,2,5,7,5,5,17,REDACTED
1843482,1,5,5,12,4,21,REDACTED
1843482,2,3,3,8,4,15,REDACTED
1843485,1,3,4,5,4,13,REDACTED
1843485,2,5,5,2,2,9,REDACTED
1843488,1,5,5,0,0,5,REDACTED
1843488,2,0,0,0,0,0,REDACTED
1843830,1,4,2,0,7,9,REDACTED
1843830,2,0,0,0,0,0,REDACTED
1844032,1,9,9,0,0,9,REDACTED
1844032,2,6,6,0,6,12,REDACTED
1844422,1,11,12,24,16,52,REDACTED
1844422,2,2,2,0,4,6,REDACTED
1844423,1,7,7,7,9,23,REDACTED
1844423,2,2,2,0,0,2,REDACTED
1844423,3,4,1,4,2,7,REDACTED
1844423,4,0,0,7,4,11,REDACTED
1844423,5,4,4,3,5,12,REDACTED
1844478,1,5,5,9,13,27,REDACTED
1844478,2,0,0,0,0,0,REDACTED
1844478,3,0,0,0,0,0,REDACTED
1844706,1,11,13,5,3,21,REDACTED
1844706,2,10,15,2,9,26,REDACTED
1844706,3,8,7,9,0,16,REDACTED
1844706,4,4,0,5,0,5,REDACTED
1846117,1,3,2,0,0,2,REDACTED
1846117,2,4,0,0,0,0,REDACTED
1846117,4,4,3,0,0,3,REDACTED
1846670,1,8,12,5,0,17,REDACTED
1846670,2,2,1,0,0,1,REDACTED
1846670,3,5,5,10,9,24,REDACTED
1846670,4,12,18,8,14,40,REDACTED
1846953,1,5,5,8,5,18,REDACTED
1847157,1,3,8,1,0,9,REDACTED
1847407,1,8,11,1,14,26,REDACTED
1847407,2,10,0,0,1,1,REDACTED
1847407,3,2,2,1,8,11,REDACTED
1847470,1,6,2,4,8,14,REDACTED
1847470,2,2,14,19,9,42,REDACTED
1847470,3,4,4,0,4,8,REDACTED
1847518,1,6,9,7,5,21,REDACTED
1847518,2,5,5,12,12,29,REDACTED
1847518,3,9,4,8,3,15,REDACTED
1848571,1,4,1,15,2,18,REDACTED
1848571,2,0,0,0,3,3,REDACTED
1848571,3,2,0,0,0,0,REDACTED
1848704,1,2,2,3,5,10,REDACTED
1848704,2,2,4,0,0,4,REDACTED
1849627,1,5,6,0,0,6,REDACTED
1850240,1,7,2,0,1,3,REDACTED
1850240,2,9,8,3,0,11,REDACTED
1850716,1,7,7,3,2,12,REDACTED
1850716,3,5,6,2,4,12,REDACTED
1850776,1,2,2,4,2,8,REDACTED
1850776,2,3,8,5,0,13,REDACTED
1851306,1,8,4,7,9,20,REDACTED
1851306,2,5,3,7,7,17,REDACTED
1851654,1,9,6,1,1,8,REDACTED
1851654,2,4,3,0,0,3,REDACTED
1851654,3,10,10,0,0,10,REDACTED
1851654,4,10,10,0,0,10,REDACTED
1852083,1,7,10,8,9,27,REDACTED
1852083,2,2,7,3,1,11,REDACTED
1852433,1,4,2,3,7,12,REDACTED
1852433,2,2,1,1,7,9,REDACTED
1852874,1,0,0,5,0,5,REDACTED
1852874,2,6,7,7,6,20,REDACTED
1852924,1,4,4,8,8,20,REDACTED
1852924,2,0,0,0,0,0,REDACTED
1853245,1,4,1,7,11,19,REDACTED
1853245,2,9,12,2,0,14,REDACTED
1853245,3,4,2,4,2,8,REDACTED
1853688,1,3,4,10,7,21,REDACTED
1853688,2,7,15,10,9,34,REDACTED
1853688,3,5,7,6,1,14,REDACTED
1853690,1,2,2,4,6,12,REDACTED
1853690,2,5,4,1,3,8,REDACTED
1853690,3,4,3,6,6,15,REDACTED
1853690,4,2,2,10,3,15,REDACTED
1854348,1,10,8,5,3,16,REDACTED
1854348,2,4,2,4,4,10,REDACTED
1854837,1,5,5,4,12,21,REDACTED
1854837,2,0,0,5,14,19,REDACTED
1855026,1,3,2,5,5,12,REDACTED
1855026,2,0,0,5,5,10,REDACTED
1855480,1,5,5,2,2,9,REDACTED
1855480,2,7,8,11,6,25,REDACTED
1856044,1,5,8,5,5,18,REDACTED
1856062,1,9,9,3,3,15,REDACTED
1856297,1,14,18,16,6,40,REDACTED
1856297,2,8,11,16,4,31,REDACTED
1856297,3,3,3,4,6,13,REDACTED
1856297,4,3,3,8,7,18,REDACTED
1856445,1,6,6,9,4,19,REDACTED
1857798,1,4,16,9,8,33,REDACTED
1857798,2,5,11,16,15,42,REDACTED
1857901,1,11,5,4,6,15,REDACTED
1857901,2,10,10,10,2,22,REDACTED
1858373,1,6,6,13,4,23,REDACTED
1858373,2,6,6,11,0,17,REDACTED
1858426,1,4,4,2,0,6,REDACTED
1858426,2,7,2,4,4,10,REDACTED
1858504,1,11,12,12,10,34,REDACTED
1858504,2,5,1,0,9,10,REDACTED
1859081,1,8,9,2,2,13,REDACTED
1859081,2,4,5,1,10,16,REDACTED
1859129,1,6,4,2,9,15,REDACTED
1859129,2,2,8,5,14,27,REDACTED
1859855,1,2,6,9,7,22,REDACTED
1859855,2,6,6,5,11,22,REDACTED
1859855,3,0,0,0,0,0,REDACTED
1859855,4,3,7,2,3,12,REDACTED
1860195,1,10,12,10,0,22,REDACTED
1860195,2,4,3,0,0,3,REDACTED
1860362,1,6,6,7,7,20,REDACTED
1860362,2,5,7,1,0,8,REDACTED
1860489,1,11,12,4,4,20,REDACTED
1860489,2,13,13,6,12,31,REDACTED
1860489,3,6,0,0,0,0,REDACTED
1861039,1,2,3,3,3,9,REDACTED
1861039,2,0,0,2,2,4,REDACTED
1861097,1,4,0,0,0,0,REDACTED
1861097,2,3,0,0,3,3,REDACTED
1861097,3,2,4,0,0,4,REDACTED
1861097,4,2,4,0,0,4,REDACTED
1861132,1,4,8,15,4,27,REDACTED
1861132,2,4,17,4,4,25,REDACTED
1861132,3,8,1,1,0,2,REDACTED
1861407,1,2,0,11,7,18,REDACTED
1861407,2,12,16,9,0,25,REDACTED
1861407,3,9,15,8,0,23,REDACTED
1861449,1,0,0,0,0,0,REDACTED
1861575,1,6,6,10,8,24,REDACTED
1861575,2,6,7,12,2,21,REDACTED
1861958,1,8,12,3,9,24,REDACTED
1861958,2,5,5,7,17,29,REDACTED
1862113,1,11,13,10,7,30,REDACTED
1862113,2,5,5,3,5,13,REDACTED
1862188,1,0,0,0,0,0,REDACTED
1862218,1,5,5,9,5,19,REDACTED
1862218,2,6,7,3,3,13,REDACTED
1862258,1,6,6,7,19,32,REDACTED
1862258,2,2,2,2,0,4,REDACTED
1862258,3,2,2,4,0,6,REDACTED
1862258,4,5,12,0,13,25,REDACTED
1862296,1,6,6,7,0,13,REDACTED
1862296,2,0,0,0,0,0,REDACTED
1862338,1,4,8,9,4,21,REDACTED
1862338,2,2,4,6,0,10,REDACTED
1862576,1,2,3,1,0,4,REDACTED
1862576,2,5,8,0,0,8,REDACTED
1862576,3,8,3,1,0,4,REDACTED
1862576,4,10,30,0,0,30,REDACTED
1862835,1,9,10,6,4,20,REDACTED
1862835,2,2,7,11,6,24,REDACTED
1862835,3,9,6,4,7,17,REDACTED
1862835,4,6,0,9,10,19,REDACTED
1863465,1,11,9,4,4,17,REDACTED
1863465,2,12,4,7,6,17,REDACTED
1863465,3,0,0,8,3,11,REDACTED
1863465,4,9,9,5,1,15,REDACTED
1864062,1,3,2,7,5,14,REDACTED
1864192,1,3,3,2,4,9,REDACTED
1864192,2,4,6,11,0,17,REDACTED
1864490,1,4,4,1,0,5,REDACTED
1864490,2,4,4,1,4,9,REDACTED
1864544,1,4,8,0,2,10,REDACTED
1864544,2,5,14,12,7,33,REDACTED
1864544,3,4,6,2,5,13,REDACTED
1865312,1,2,9,0,0,9,REDACTED
1865603,1,0,4,0,0,4,REDACTED
1865603,2,8,11,0,0,11,REDACTED
1866416,1,6,4,6,2,12,REDACTED
1866553,1,6,8,0,4,12,REDACTED
1866553,2,6,7,1,3,11,REDACTED
1866580,1,5,2,7,8,17,REDACTED
1866580,2,8,6,13,6,25,REDACTED
1866895,1,2,3,17,0,20,REDACTED
1867185,1,2,2,12,0,14,REDACTED
1867185,2,2,2,0,4,6,REDACTED
1867413,1,2,5,11,10,26,REDACTED
1867507,1,9,10,6,2,18,REDACTED
1868081,1,3,4,9,7,20,REDACTED
1868081,2,8,8,7,13,28,REDACTED
1868152,1,5,0,2,16,18,REDACTED
1868152,2,3,3,10,17,30,REDACTED
1868152,3,4,2,10,0,12,REDACTED
1868152,4,2,2,10,8,20,REDACTED
1868226,1,13,11,0,0,11,REDACTED
1868226,2,4,2,0,0,2,REDACTED
1868436,1,4,7,7,7,21,REDACTED
1868501,1,8,9,6,1,16,REDACTED
1869748,1,0,0,6,7,13,REDACTED
1869748,2,0,0,6,7,13,REDACTED
1869748,3,0,0,6,7,13,REDACTED
1869748,4,0,0,2,7,9,REDACTED
1869748,5,0,0,6,7,13,REDACTED
1870037,1,13,22,11,5,38,REDACTED
1870037,2,0,11,19,21,51,REDACTED
1870419,1,8,7,0,0,7,REDACTED
1870439,1,2,5,2,0,7,REDACTED
1870530,1,2,2,3,2,7,REDACTED
1870530,2,4,4,3,11,18,REDACTED
1870728,1,6,6,12,9,27,REDACTED
1870728,2,10,12,14,4,30,REDACTED
1870728,3,3,3,1,0,4,REDACTED
1870841,1,5,5,7,6,18,REDACTED
1870841,2,8,8,2,8,18,REDACTED
1870841,3,9,9,13,2,24,REDACTED
1871017,1,10,1,5,4,10,REDACTED
1871017,2,5,4,0,0,4,REDACTED
1871579,1,4,4,3,3,10,REDACTED
1871728,1,4,4,6,4,14,REDACTED
1871728,2,4,3,4,1,8,REDACTED
1872323,1,6,6,1,5,12,REDACTED
1872323,2,0,1,1,5,7,REDACTED
1872947,1,4,4,3,0,7,REDACTED
1873022,1,6,3,1,0,4,REDACTED
1873022,2,0,7,6,0,13,REDACTED
1873699,1,2,3,0,2,5,REDACTED
1873699,2,0,0,5,0,5,REDACTED
1873728,1,7,7,8,7,22,REDACTED
1873740,1,0,0,6,5,11,REDACTED
1873740,2,0,0,8,9,17,REDACTED
1874065,1,8,5,7,4,16,REDACTED
1874065,2,8,8,8,12,28,REDACTED
1874245,1,3,1,1,0,2,REDACTED
1874245,2,6,8,11,7,26,REDACTED
1874375,1,2,0,5,7,12,REDACTED
1874375,2,2,2,1,5,8,REDACTED
1874375,3,2,2,5,2,9,REDACTED
1875397,1,9,9,13,2,24,REDACTED
1875397,2,4,3,4,2,9,REDACTED
1875523,1,8,7,7,5,19,REDACTED
1875523,2,16,19,11,4,34,REDACTED
1876270,1,0,0,0,4,4,REDACTED
1876270,2,0,0,5,15,20,REDACTED
1876604,1,4,12,19,13,44,REDACTED
1876604,2,7,12,6,6,24,REDACTED
1876604,3,11,23,11,7,41,REDACTED
1877252,1,5,3,4,6,13,REDACTED
1877252,2,3,2,5,4,11,REDACTED
1877316,1,7,8,8,0,16,REDACTED
1877316,2,10,11,5,0,16,REDACTED
1877547,1,9,13,6,0,19,REDACTED
1877547,2,2,4,4,3,11,REDACTED
1878606,1,3,3,3,3,9,REDACTED
1878866,1,7,9,11,7,27,REDACTED
1878866,2,6,6,5,9,20,REDACTED
1879404,1,0,0,0,0,0,REDACTED
1879404,2,0,0,0,0,0,REDACTED
1879450,1,9,15,8,10,33,REDACTED
1879543,1,11,11,9,8,28,REDACTED
1879543,2,4,5,2,3,10,REDACTED
1880103,1,6,6,4,6,16,REDACTED
1880135,1,2,2,3,0,5,REDACTED
1880135,2,0,0,0,0,0,REDACTED
1880665,1,2,3,4,2,9,REDACTED
1880665,2,4,4,3,2,9,REDACTED
1881205,1,2,9,8,10,27,REDACTED
1881205,2,0,7,5,3,15,REDACTED
1881813,1,9,6,8,3,17,REDACTED
1881813,2,0,0,0,0,0,REDACTED
1882557,1,3,3,0,0,3,REDACTED
1882557,2,0,0,2,2,4,REDACTED
1883022,1,2,2,0,2,4,REDACTED
1883022,2,4,4,2,3,9,REDACTED
1883934,1,4,2,7,4,13,REDACTED
1883934,2,11,10,2,14,26,REDACTED
1883961,1,9,10,9,8,27,REDACTED
1884501,1,5,9,4,3,16,REDACTED
1884501,2,6,13,4,9,26,REDACTED
1884839,1,11,12,10,11,33,REDACTED
1885105,1,11,12,11,9,32,REDACTED
1885105,2,11,12,2,12,26,REDACTED
1885105,5,5,7,4,0,11,REDACTED
1886117,1,4,5,7,9,21,REDACTED
1886295,1,12,10,11,0,21,REDACTED
1886295,2,2,5,0,12,17,REDACTED
1886378,1,5,6,4,5,15,REDACTED
1886380,1,5,5,9,0,14,REDACTED
1886380,2,4,5,7,11,23,REDACTED
1886380,3,2,3,5,0,8,REDACTED
1886648,1,11,15,0,0,15,REDACTED
1886648,2,8,13,0,0,13,REDACTED
1886693,1,2,2,4,3,9,REDACTED
1886693,2,0,0,1,3,4,REDACTED
1887460,1,6,4,5,5,14,REDACTED
1887700,1,8,8,11,9,28,REDACTED
1887700,2,6,6,0,0,6,REDACTED
1887895,1,7,7,5,15,27,REDACTED
1888035,1,11,10,1,7,18,REDACTED
1888035,2,3,1,11,3,15,REDACTED
1888132,1,8,11,4,8,23,REDACTED
1888132,2,6,5,4,4,13,REDACTED
1888132,3,0,0,0,0,0,REDACTED
1888132,4,4,10,6,4,20,REDACTED
1888275,1,10,14,6,10,30,REDACTED
1888275,2,4,4,6,5,15,REDACTED
1888275,3,3,4,10,0,14,REDACTED
1888375,1,7,12,9,7,28,REDACTED
1888375,2,4,6,3,3,12,REDACTED
1888813,1,2,4,6,8,18,REDACTED
1889086,1,5,5,6,4,15,REDACTED
1889086,2,2,2,3,7,12,REDACTED
1889268,1,4,4,7,8,19,REDACTED
1890511,1,5,5,7,5,17,REDACTED
1890511,2,5,5,2,3,10,REDACTED
1890703,1,4,4,5,2,11,REDACTED
1890703,2,7,7,3,3,13,REDACTED
1891320,1,7,4,18,14,36,REDACTED
1891320,2,7,10,0,0,10,REDACTED
1891320,3,6,4,13,16,33,REDACTED
1891331,1,4,6,8,8,22,REDACTED
1891331,2,3,10,3,8,21,REDACTED
1893111,1,7,7,1,3,11,REDACTED
1893998,1,4,7,7,0,14,REDACTED
1894347,1,11,14,6,1,21,REDACTED
1894347,2,9,9,7,0,16,REDACTED
1895174,1,0,1,0,7,8,REDACTED
1895174,2,2,1,3,6,10,REDACTED
1895174,3,2,3,4,0,7,REDACTED
1895174,4,2,4,0,2,6,REDACTED
1895198,1,10,10,6,8,24,REDACTED
1895198,2,5,3,5,3,11,REDACTED
1895284,1,4,5,4,5,14,REDACTED
1895284,2,7,9,9,8,26,REDACTED
1895284,3,0,0,4,3,7,REDACTED
1895341,1,4,4,7,2,13,REDACTED
1895341,2,8,13,11,14,38,REDACTED
1896009,1,0,10,15,17,42,REDACTED
1896009,2,5,5,2,2,9,REDACTED
1896078,1,9,12,8,7,27,REDACTED
1896127,1,4,10,7,2,19,REDACTED
1896127,2,6,6,2,2,10,REDACTED
1896127,3,0,0,13,3,16,REDACTED
1896127,4,5,10,1,1,12,REDACTED
1896133,1,3,6,7,5,18,REDACTED
1897324,1,3,8,4,1,13,REDACTED
1897805,1,7,5,10,8,23,REDACTED
1897805,2,0,0,0,0,0,REDACTED
1897869,1,4,6,4,0,10,REDACTED
1898304,1,9,12,0,6,18,REDACTED
1898304,2,6,12,0,6,18,REDACTED
1898314,1,5,5,4,3,12,REDACTED
1898314,2,13,17,14,6,37,REDACTED
1898379,1,4,4,0,10,14,REDACTED
1898379,2,7,8,8,11,27,REDACTED
1898865,1,8,8,6,2,16,REDACTED
1898865,2,8,8,2,3,13,REDACTED
1898895,1,3,3,0,5,8,REDACTED
1898895,2,2,0,0,0,0,REDACTED
1898895,3,2,5,5,0,10,REDACTED
1899208,1,8,17,2,11,30,REDACTED
1899208,2,2,2,2,3,7,REDACTED
1899208,3,4,9,7,5,21,REDACTED
1899669,1,8,11,2,10,23,REDACTED
1899669,2,6,0,3,2,5,REDACTED
1899669,3,0,0,5,2,7,REDACTED
1899852,1,7,16,11,16,43,REDACTED
1899852,2,10,16,9,13,38,REDACTED
1899852,3,0,17,3,18,38,REDACTED
1900120,1,2,6,0,6,12,REDACTED
1900120,2,2,6,0,2,8,REDACTED
1900406,1,1,5,6,0,11,REDACTED
1900653,1,3,7,6,2,15,REDACTED
1900653,2,3,6,2,2,10,REDACTED
1901626,1,3,3,2,2,7,REDACTED
1901626,2,6,10,10,5,25,REDACTED
1901695,1,5,8,3,5,16,REDACTED
1901695,2,5,4,5,2,11,REDACTED
1902105,1,5,5,6,0,11,REDACTED
1902105,2,5,11,7,2,20,REDACTED
1902105,3,2,3,11,2,16,REDACTED
1902105,4,2,10,4,8,22,REDACTED
1902190,1,0,0,0,0,0,REDACTED
1902190,2,0,0,0,0,0,REDACTED
1902190,3,0,0,0,0,0,REDACTED
1902213,1,0,0,1,8,9,REDACTED
1902213,2,7,7,2,5,14,REDACTED
1902628,1,4,5,14,2,21,REDACTED
1902628,2,6,7,5,12,24,REDACTED
1902628,3,7,7,8,6,21,REDACTED
1902889,1,6,6,11,2,19,REDACTED
1902889,2,0,0,6,4,10,REDACTED
1902889,5,4,4,12,14,30,REDACTED
1903076,1,2,2,1,0,3,REDACTED
1903076,2,0,0,0,0,0,REDACTED
1903315,1,9,9,6,1,16,REDACTED
1903315,2,8,10,4,3,17,REDACTED
1903524,1,0,0,1,3,4,REDACTED
1903524,2,5,7,9,0,16,REDACTED
1903532,1,3,0,11,3,14,REDACTED
1903532,2,0,0,0,4,4,REDACTED
1903532,3,2,7,3,0,10,REDACTED
1903532,4,7,8,12,9,29,REDACTED
1904222,1,4,3,13,11,27,REDACTED
1904222,2,0,4,0,8,12,REDACTED
1904347,1,10,8,6,2,16,REDACTED
1904347,2,4,0,4,2,6,REDACTED
1904347,3,4,5,0,3,8,REDACTED
1904755,1,10,10,0,3,13,REDACTED
1905059,1,11,9,6,9,24,REDACTED
1905059,2,2,2,0,0,2,REDACTED
1905415,1,2,2,0,2,4,REDACTED
1905415,2,0,0,8,7,15,REDACTED
1906086,1,6,8,12,6,26,REDACTED
1906086,2,4,5,3,3,11,REDACTED
1906374,1,9,5,15,3,23,REDACTED
1906374,2,10,1,5,0,6,REDACTED
1906413,1,3,3,3,1,7,REDACTED
1906413,2,0,0,0,0,0,REDACTED
1906455,1,3,4,8,5,17,REDACTED
1908202,1,4,4,4,0,8,REDACTED
1908202,2,3,4,2,3,9,REDACTED
1908256,1,4,4,7,4,15,REDACTED
1908256,2,0,0,5,0,5,REDACTED
1908468,1,4,4,8,3,15,REDACTED
1908468,2,4,10,12,11,33,REDACTED
1908855,1,2,3,3,9,15,REDACTED
1908855,2,2,3,4,4,11,REDACTED
1908937,1,2,2,0,5,7,REDACTED
1908937,2,2,2,3,5,10,REDACTED
1909133,1,11,2,1,2,5,REDACTED
1909133,2,8,12,16,4,32,REDACTED
1909247,1,2,3,3,4,10,REDACTED
1909247,2,2,2,5,8,15,REDACTED
1909247,3,2,4,9,11,24,REDACTED
1910592,1,4,2,8,4,14,REDACTED
1910592,2,4,12,10,0,22,REDACTED
1910777,1,8,5,4,5,14,REDACTED
1910777,2,6,6,0,0,6,REDACTED
1910977,1,4,4,3,7,14,REDACTED
1910977,2,0,0,0,0,0,REDACTED
1911175,1,5,5,2,15,22,REDACTED
1911175,2,6,6,6,9,21,REDACTED
1911224,1,3,3,5,25,33,REDACTED
1911224,2,6,6,6,3,15,REDACTED
1911679,1,4,5,6,10,21,REDACTED
1911679,2,6,5,0,9,14,REDACTED
1911679,3,0,0,6,4,10,REDACTED
1911685,1,7,10,3,5,18,REDACTED
1911685,2,13,2,0,0,2,REDACTED
1911738,1,0,0,0,0,0,REDACTED
1911738,2,5,15,3,4,22,REDACTED
1911786,1,11,2,7,5,14,REDACTED
1911992,1,0,6,3,0,9,REDACTED
1911992,2,0,4,3,0,7,REDACTED
1912085,1,5,5,5,0,10,REDACTED
1912085,2,6,6,5,0,11,REDACTED
1912276,1,9,10,6,8,24,REDACTED
1912276,2,7,9,5,3,17,REDACTED
1912458,1,8,13,3,4,20,REDACTED
1912458,2,2,1,0,0,1,REDACTED
1912517,1,10,10,6,4,20,REDACTED
1912517,2,2,2,6,0,8,REDACTED
1912597,1,2,3,5,4,12,REDACTED
1912597,2,2,2,2,3,7,REDACTED
1912597,3,2,8,5,7,20,REDACTED
1912597,4,2,10,5,22,37,REDACTED
1912760,1,1,3,5,8,16,REDACTED
1912760,2,7,3,5,13,21,REDACTED
1912760,3,3,2,4,2,8,REDACTED
1913749,1,4,7,0,0,7,REDACTED
1913749,2,1,2,0,0,2,REDACTED
1913924,1,4,4,1,6,11,REDACTED
1913924,2,4,2,4,0,6,REDACTED
1914879,1,0,0,0,2,2,REDACTED
1914879,2,8,3,3,4,10,REDACTED
1914879,3,0,0,0,3,3,REDACTED
1914879,4,0,0,0,2,2,REDACTED
1914918,1,6,7,10,5,22,REDACTED
1914918,2,7,12,5,3,20,REDACTED
1915096,1,4,5,2,0,7,REDACTED
1915096,2,4,8,12,11,31,REDACTED
1915247,1,4,4,4,2,10,REDACTED
1915247,2,6,4,1,6,11,REDACTED
1915701,1,6,6,14,13,33,REDACTED
1915701,2,7,8,7,4,19,REDACTED
1915701,3,10,8,0,0,8,REDACTED
1915701,4,10,17,0,3,20,REDACTED
1915901,1,7,7,5,11,23,REDACTED
1916436,1,2,3,2,1,6,REDACTED
1916436,2,6,9,4,6,19,REDACTED
1916481,1,3,3,0,0,3,REDACTED
1916481,2,2,2,0,0,2,REDACTED
1916481,3,0,4,9,3,16,REDACTED
1917034,1,4,7,0,0,7,REDACTED
1917034,2,3,6,4,0,10,REDACTED
1918923,1,6,6,2,9,17,REDACTED
1918923,2,8,9,6,6,21,REDACTED
1919177,1,6,3,7,5,15,REDACTED
1919539,1,9,3,3,3,9,REDACTED
1919539,2,6,1,6,6,13,REDACTED
1919791,1,5,7,7,11,25,REDACTED
1919791,2,6,7,0,4,11,REDACTED
1920239,1,2,2,0,8,10,REDACTED
1921291,1,8,8,0,0,8,REDACTED
1921291,2,4,4,0,0,4,REDACTED
1922464,1,10,10,0,0,10,REDACTED
1922486,1,6,6,7,4,17,REDACTED
1922486,2,3,3,2,6,11,REDACTED
1922495,1,11,11,8,9,28,REDACTED
1922495,2,7,2,6,9,17,REDACTED
1922608,1,6,4,5,3,12,REDACTED
1924344,1,3,3,5,7,15,REDACTED
1924344,2,0,0,5,0,5,REDACTED
1924453,1,6,1,2,3,6,REDACTED
1924453,2,2,2,5,2,9,REDACTED
1924753,1,14,4,0,0,4,REDACTED
1924753,2,2,2,5,0,7,REDACTED
1924878,1,0,0,6,0,6,REDACTED
1924878,2,0,0,0,0,0,REDACTED
1924878,3,7,9,4,2,15,REDACTED
1925081,1,8,9,7,3,19,REDACTED
1925372,1,6,3,14,2,19,REDACTED
1925372,2,2,0,0,0,0,REDACTED
1925372,3,2,3,0,0,3,REDACTED
1925372,4,4,16,6,7,29,REDACTED
1925636,1,10,8,6,6,20,REDACTED
1925636,2,5,5,12,6,23,REDACTED
1925786,1,8,7,7,2,16,REDACTED
1925786,2,7,6,8,3,17,REDACTED
1925786,3,4,2,4,4,10,REDACTED
1925786,4,5,5,5,2,12,REDACTED
1925811,1,9,8,3,5,16,REDACTED
1926189,1,2,3,3,0,6,REDACTED
1926189,2,3,3,6,0,9,REDACTED
1926244,1,9,10,5,5,20,REDACTED
1926244,2,11,5,5,2,12,REDACTED
1926397,1,8,8,13,2,23,REDACTED
1926397,2,0,0,0,0,0,REDACTED
1926503,1,0,9,6,13,28,REDACTED
1926503,2,11,15,5,8,28,REDACTED
1926816,1,16,16,7,9,32,REDACTED
1926816,2,7,8,0,8,16,REDACTED
1926884,1,4,8,9,8,25,REDACTED
1926884,2,2,1,5,2,8,REDACTED
1928414,1,0,0,0,0,0,REDACTED
1928414,2,6,5,3,0,8,REDACTED
1928414,3,4,4,15,2,21,REDACTED
1928813,1,6,8,0,8,16,REDACTED
1928813,2,2,3,2,5,10,REDACTED
1928813,3,5,3,6,3,12,REDACTED
1929207,1,8,4,15,11,30,REDACTED
1929207,2,0,0,8,0,8,REDACTED
1929207,3,2,2,2,0,4,REDACTED
1929207,4,4,7,8,4,19,REDACTED
1929441,1,5,8,3,5,16,REDACTED
1929524,1,5,6,6,1,13,REDACTED
1929524,2,6,6,4,3,13,REDACTED
1929524,3,0,0,0,6,6,REDACTED
1929524,4,2,4,6,1,11,REDACTED
1929767,1,0,0,9,6,15,REDACTED
1929767,2,0,0,8,5,13,REDACTED
1929767,3,0,0,9,6,15,REDACTED
1929916,1,5,3,8,0,11,REDACTED
1930525,1,6,5,0,0,5,REDACTED
1930525,2,4,0,0,0,0,REDACTED
1930525,3,0,0,0,0,0,REDACTED
1930988,1,11,10,8,7,25,REDACTED
1930988,2,3,0,8,4,12,REDACTED
1930988,3,6,6,8,1,15,REDACTED
1930988,4,4,9,4,6,19,REDACTED
1931074,1,12,0,5,12,17,REDACTED
1931074,2,4,5,1,0,6,REDACTED
1931074,3,13,18,5,2,25,REDACTED
1931074,4,8,14,2,0,16,REDACTED
1931629,1,2,2,4,0,6,REDACTED
1931629,2,0,0,8,6,14,REDACTED
1931629,3,0,0,0,0,0,REDACTED
1931857,1,4,2,2,6,10,REDACTED
1931857,2,2,2,0,0,2,REDACTED
1931862,1,2,3,10,2,15,REDACTED
1931862,2,2,1,2,2,5,REDACTED
1932253,1,2,5,9,0,14,REDACTED
1932253,2,4,13,4,5,22,REDACTED
1932253,3,6,5,0,8,13,REDACTED
1932621,1,0,7,4,1,12,REDACTED
1933151,1,0,0,15,2,17,REDACTED
1933151,2,5,5,11,1,17,REDACTED
1933151,3,4,5,13,0,18,REDACTED
1933969,1,5,4,4,7,15,REDACTED
1933969,2,2,1,5,4,10,REDACTED
1933969,3,9,6,8,10,24,REDACTED
1933969,4,8,2,1,0,3,REDACTED
1934818,1,3,9,10,3,22,REDACTED
1934818,2,6,5,8,3,16,REDACTED
1934959,1,5,6,2,15,23,REDACTED
1934959,2,9,2,7,3,12,REDACTED
1934959,3,7,9,3,4,16,REDACTED
1935177,1,7,6,3,7,16,REDACTED
1935951,1,8,18,8,11,37,REDACTED
1935951,2,5,5,5,5,15,REDACTED
1936018,1,2,5,3,4,12,REDACTED
1936068,1,2,4,3,5,12,REDACTED
1936068,2,2,6,18,6,30,REDACTED
1936556,1,4,6,3,6,15,REDACTED
1936556,2,6,7,0,7,14,REDACTED
1937380,1,3,3,7,7,17,REDACTED
1937539,1,4,4,7,4,15,REDACTED
1937613,1,9,1,0,0,1,REDACTED
1937613,2,14,6,7,11,24,REDACTED
1937613,3,5,5,0,0,5,REDACTED
1937732,2,4,1,1,0,2,REDACTED
1937840,1,0,0,0,0,0,REDACTED
1937840,2,0,0,0,0,0,REDACTED
1938073,1,2,1,3,2,6,REDACTED
1938073,2,2,2,3,3,8,REDACTED
1938807,1,3,2,0,0,2,REDACTED
1938807,2,6,4,19,0,23,REDACTED
1939112,1,4,5,2,9,16,REDACTED
1939112,2,10,8,3,4,15,REDACTED
1939112,3,4,10,4,8,22,REDACTED
1939112,4,5,12,6,11,29,REDACTED
1939267,1,15,15,9,16,40,REDACTED
1939267,2,10,18,5,6,29,REDACTED
1939702,1,0,0,2,0,2,REDACTED
1939702,2,4,4,4,2,10,REDACTED
1939898,1,2,1,2,2,5,REDACTED
1939898,2,6,2,8,7,17,REDACTED
1940564,1,2,6,5,8,19,REDACTED
1940564,2,3,2,4,8,14,REDACTED
1940564,3,6,1,2,1,4,REDACTED
1940607,1,7,9,0,0,9,REDACTED
1940607,3,0,0,0,0,0,REDACTED
1940749,1,7,7,3,3,13,REDACTED
1941157,1,5,5,1,4,10,REDACTED
1941157,2,8,2,4,10,16,REDACTED
1941157,3,8,6,4,10,20,REDACTED
1941336,1,11,12,13,0,25,REDACTED
1941336,2,4,7,5,0,12,REDACTED
1942229,1,5,8,16,7,31,REDACTED
1942229,2,6,8,7,6,21,REDACTED
1942244,1,6,6,12,6,24,REDACTED
1942376,1,6,9,8,6,23,REDACTED
1942376,2,3,6,0,0,6,REDACTED
1942390,1,5,5,4,3,12,REDACTED
1942390,2,5,7,1,6,14,REDACTED
1942759,1,4,7,5,3,15,REDACTED
1942821,1,4,9,0,0,9,REDACTED
1942821,2,0,0,0,0,0,REDACTED
1942930,1,8,8,11,0,19,REDACTED
1942930,2,8,10,10,0,20,REDACTED
1943391,1,6,6,8,7,21,REDACTED
1943450,1,7,7,8,11,26,REDACTED
1943450,2,0,0,0,0,0,REDACTED
1943585,1,4,2,7,4,13,REDACTED
1943585,2,2,1,2,9,12,REDACTED
1944655,1,2,4,5,7,16,REDACTED
1945506,1,8,10,5,6,21,REDACTED
1945506,2,5,6,0,17,23,REDACTED
1945949,1,12,11,7,9,27,REDACTED
1945949,2,7,8,5,0,13,REDACTED
1945975,1,5,4,0,0,4,REDACTED
1947163,1,3,4,3,0,7,REDACTED
1947494,1,2,3,0,0,3,REDACTED
1947494,2,8,5,0,0,5,REDACTED
1947494,3,7,15,0,0,15,REDACTED
1947494,4,7,15,0,0,15,REDACTED
1947504,1,4,5,19,3,27,REDACTED
1947504,2,5,1,6,8,15,REDACTED
1947816,1,9,8,9,3,20,REDACTED
1948026,2,0,0,0,0,0,REDACTED
1948105,1,6,5,8,9,22,REDACTED
1948105,2,9,12,16,9,37,REDACTED
1948177,1,7,10,27,10,47,REDACTED
1948177,2,2,2,4,8,14,REDACTED
1949573,1,5,8,6,0,14,REDACTED
1949573,2,2,6,3,0,9,REDACTED
1949573,3,8,0,4,4,8,REDACTED
1949746,1,4,24,16,17,57,REDACTED
1949746,2,3,6,3,6,15,REDACTED
1949746,3,0,0,1,0,1,REDACTED
1949907,1,12,7,5,5,17,REDACTED
1950282,1,3,6,4,2,12,REDACTED
1950282,2,0,0,0,0,0,REDACTED
1950554,1,9,10,14,3,27,REDACTED
1950554,2,6,5,5,3,13,REDACTED
1950600,1,7,8,3,13,24,REDACTED
1950600,2,3,3,4,6,13,REDACTED
1950609,1,6,6,0,6,12,REDACTED
1950609,2,7,12,4,0,16,REDACTED
1951510,1,5,9,0,11,20,REDACTED
1951510,2,5,10,0,5,15,REDACTED
1951581,1,10,9,10,4,23,REDACTED
1952387,1,2,3,0,3,6,REDACTED
1952633,1,6,9,10,11,30,REDACTED
1952633,2,0,0,0,0,0,REDACTED
1952633,3,3,3,8,4,15,REDACTED
1952633,4,7,7,3,6,16,REDACTED
1952763,1,0,0,0,5,5,REDACTED
1952763,2,7,7,8,7,22,REDACTED
1953109,1,6,4,7,4,15,REDACTED
1953109,2,12,0,9,15,24,REDACTED
1953109,3,4,2,7,2,11,REDACTED
1953460,1,0,0,3,5,8,REDACTED
1953460,2,0,0,3,5,8,REDACTED
1953460,4,0,0,0,0,0,REDACTED
1953728,1,14,12,6,12,30,REDACTED
1953728,2,10,11,4,10,25,REDACTED
1954062,1,10,7,9,6,22,REDACTED
1954062,2,6,13,11,9,33,REDACTED
1954062,3,2,12,8,10,30,REDACTED
1954433,1,9,8,16,2,26,REDACTED
1954433,2,5,6,3,2,11,REDACTED
1954813,1,4,4,6,0,10,REDACTED
1954813,2,14,16,9,0,25,REDACTED
1954813,3,5,7,6,0,13,REDACTED
1954813,4,3,15,0,0,15,REDACTED
1954973,1,7,6,4,0,10,REDACTED
1955233,1,6,6,7,7,20,REDACTED
1955233,2,9,9,2,9,20,REDACTED
1955449,1,4,3,0,0,3,REDACTED
1955449,2,2,2,0,0,2,REDACTED
1956176,1,5,5,5,13,23,REDACTED
1956176,2,7,8,4,9,21,REDACTED
1956182,1,0,0,7,7,14,REDACTED
1956540,1,9,9,2,8,19,REDACTED
1956919,1,13,13,0,12,25,REDACTED
1956919,2,2,7,6,1,14,REDACTED
1956919,3,8,4,0,2,6,REDACTED
1957733,1,5,5,2,4,11,REDACTED
1957733,2,9,12,9,1,22,REDACTED
1957896,1,7,3,5,0,8,REDACTED
1958029,1,2,2,2,4,8,REDACTED
1958147,1,7,7,1,4,12,REDACTED
1958147,2,10,22,5,5,32,REDACTED
1958147,3,2,9,3,4,16,REDACTED
1958391,1,4,7,1,3,11,REDACTED
1958391,2,5,9,0,0,9,REDACTED
1958479,1,0,3,0,0,3,REDACTED
1959857,1,10,14,9,13,36,REDACTED
1960857,2,4,4,9,10,23,REDACTED
1961067,1,6,8,6,4,18,REDACTED
1961067,2,3,4,3,0,7,REDACTED
1961193,1,4,4,0,1,5,REDACTED
1961193,2,8,11,12,8,31,REDACTED
1961193,3,5,5,7,3,15,REDACTED
1961297,1,8,8,9,4,21,REDACTED
1961297,2,5,3,4,15,22,REDACTED
1961397,1,3,2,6,1,9,REDACTED
1961397,2,10,10,5,1,16,REDACTED
1961397,3,3,3,4,1,8,REDACTED
1961824,1,0,0,3,6,9,REDACTED
1961824,2,0,0,9,3,12,REDACTED
1961824,3,0,0,6,12,18,REDACTED
1961915,1,2,3,5,4,12,REDACTED
1961937,1,2,1,0,3,4,REDACTED
1961937,2,6,6,7,5,18,REDACTED
1962228,1,2,3,3,8,14,REDACTED
1962228,2,5,7,4,2,13,REDACTED
1962281,1,9,8,3,6,17,REDACTED
1962281,2,12,12,7,16,35,REDACTED
1962464,1,6,9,3,4,16,REDACTED
1963757,1,7,5,0,0,5,REDACTED
1963757,2,2,2,0,0,2,REDACTED
1963977,1,0,0,5,7,12,REDACTED
1963977,2,0,0,0,3,3,REDACTED
1964666,1,3,5,0,6,11,REDACTED
1964832,1,6,6,0,5,11,REDACTED
1964832,2,0,0,0,0,0,REDACTED
1965740,1,5,6,7,0,13,REDACTED
1965740,2,9,11,16,6,33,REDACTED
1965740,3,3,7,2,3,12,REDACTED
1966685,1,8,9,10,10,29,REDACTED
1967577,1,8,8,5,9,22,REDACTED
1968151,1,4,4,8,5,17,REDACTED
1968151,2,0,0,0,0,0,REDACTED
1968166,1,0,0,0,0,0,REDACTED
1968166,2,4,2,0,0,2,REDACTED
1968293,1,0,0,0,0,0,REDACTED
1968293,2,0,0,0,0,0,REDACTED
1969045,1,7,8,0,0,8,REDACTED
1969045,2,3,3,0,0,3,REDACTED
1969045,3,8,11,0,0,11,REDACTED
1969244,1,5,2,0,0,2,REDACTED
1969244,2,8,5,8,14,27,REDACTED
1969425,1,0,0,0,0,0,REDACTED
1969737,1,6,7,21,24,52,REDACTED
1969737,2,2,1,6,11,18,REDACTED
1969737,3,4,13,8,0,21,REDACTED
1969737,4,4,2,8,6,16,REDACTED
1969737,5,2,10,15,18,43,REDACTED
1969806,1,6,6,0,0,6,REDACTED
1969818,1,0,0,1,1,2,REDACTED
1969818,2,4,5,4,0,9,REDACTED
1969872,1,6,6,0,0,6,REDACTED
1970926,1,2,2,3,5,10,REDACTED
1970926,2,2,3,4,7,14,REDACTED
1970948,1,2,6,9,10,25,REDACTED
1971030,1,10,4,3,2,9,REDACTED
1971030,2,0,0,7,0,7,REDACTED
1971163,1,9,10,2,3,15,REDACTED
1971163,2,3,4,0,0,4,REDACTED
1971550,1,4,4,5,2,11,REDACTED
1973274,1,10,14,6,5,25,REDACTED
1973648,1,0,0,8,0,8,REDACTED
1973648,2,0,0,8,0,8,REDACTED
1973648,3,4,5,8,0,13,REDACTED
1973832,1,7,7,16,7,30,REDACTED
1973832,2,2,2,4,3,9,REDACTED
1973966,1,2,4,10,0,14,REDACTED
1974023,1,0,0,0,0,0,REDACTED
1974023,2,2,2,5,10,17,REDACTED
1974789,1,7,7,7,7,21,REDACTED
1974956,1,8,8,10,5,23,REDACTED
1974956,2,11,7,6,12,25,REDACTED
1974956,3,4,7,2,10,19,REDACTED
1974956,4,10,10,7,5,22,REDACTED
1974999,1,4,3,8,5,16,REDACTED
1974999,2,4,5,6,2,13,REDACTED
1975233,1,12,4,3,4,11,REDACTED
1975233,2,10,4,7,2,13,REDACTED
1975269,1,5,5,16,5,26,REDACTED
1975269,2,5,5,7,2,14,REDACTED
1975427,1,0,0,0,9,9,REDACTED
1975427,2,0,0,0,9,9,REDACTED
1975531,1,7,8,12,11,31,REDACTED
1975531,2,7,7,0,5,12,REDACTED
1975627,1,5,1,0,0,1,REDACTED
1975682,1,8,8,12,6,26,REDACTED
1975682,2,3,3,2,8,13,REDACTED
1975682,3,0,0,3,7,10,REDACTED
1975682,4,11,7,4,4,15,REDACTED
1976261,1,4,4,1,3,8,REDACTED
1976261,2,2,2,13,0,15,REDACTED
1977792,1,7,7,4,0,11,REDACTED
1979159,1,12,7,9,1,17,REDACTED
1979159,2,8,8,4,9,21,REDACTED
1979188,1,3,3,4,4,11,REDACTED
1979188,2,4,5,4,0,9,REDACTED
1979508,1,7,10,0,0,10,REDACTED
1979508,2,3,2,3,0,5,REDACTED
1980240,1,9,9,7,4,20,REDACTED
1980240,2,5,2,5,5,12,REDACTED
1980359,1,7,10,0,4,14,REDACTED
1980648,1,6,6,2,9,17,REDACTED
1980648,2,3,2,2,7,11,REDACTED
1980648,3,3,7,0,1,8,REDACTED
1981040,1,10,15,7,4,26,REDACTED
1981480,1,0,0,4,1,5,REDACTED
1981480,2,0,0,2,0,2,REDACTED
1981480,3,0,0,4,0,4,REDACTED
1981597,1,8,9,0,0,9,REDACTED
1981677,1,5,12,0,0,12,REDACTED
1981712,1,4,4,0,0,4,REDACTED
1981973,1,2,4,2,0,6,REDACTED
1981973,3,2,16,0,0,16,REDACTED
1982027,1,10,5,0,0,5,REDACTED
1982027,2,6,7,6,14,27,REDACTED
1982173,1,4,11,9,0,20,REDACTED
1982173,2,6,3,1,17,21,REDACTED
1982173,3,2,0,2,10,12,REDACTED
1982198,1,3,2,5,5,12,REDACTED
1982198,2,0,0,4,2,6,REDACTED
1982268,1,6,9,13,8,30,REDACTED
1982268,2,6,7,14,12,33,REDACTED
1982441,1,13,16,13,3,32,REDACTED
1982588,1,4,4,4,3,11,REDACTED
1982876,1,11,12,7,20,39,REDACTED
1982908,1,5,4,3,1,8,REDACTED
1983033,1,5,5,2,6,13,REDACTED
1983696,1,2,2,6,0,8,REDACTED
1983696,2,4,4,4,3,11,REDACTED
1985002,1,7,13,10,19,42,REDACTED
1985002,2,9,11,17,4,32,REDACTED
1985002,3,7,11,7,7,25,REDACTED
1985228,1,2,2,3,2,7,REDACTED
1985228,2,15,22,14,10,46,REDACTED
1986829,1,3,16,25,2,43,REDACTED
1986829,2,7,9,8,2,19,REDACTED
1986829,3,0,0,0,0,0,REDACTED
1986829,4,3,12,0,0,12,REDACTED
1986888,1,4,4,2,1,7,REDACTED
1987242,1,0,0,0,0,0,REDACTED
1987242,2,9,10,12,6,28,REDACTED
1987242,3,0,0,0,0,0,REDACTED
1987242,4,2,2,1,5,8,REDACTED
1987589,1,11,12,7,10,29,REDACTED
1987589,2,2,1,5,2,8,REDACTED
1988769,1,2,4,0,0,4,REDACTED
1988769,2,2,1,0,0,1,REDACTED
1990215,1,5,7,3,2,12,REDACTED
1990215,2,0,6,4,2,12,REDACTED
1990271,3,0,0,4,6,10,REDACTED
1991080,1,4,4,6,9,19,REDACTED
1991080,2,2,3,15,5,23,REDACTED
1991496,1,3,6,0,0,6,REDACTED
1991496,2,0,6,0,0,6,REDACTED
1991496,3,4,0,0,0,0,REDACTED
1991496,4,0,0,0,0,0,REDACTED
1991693,1,4,8,11,6,25,REDACTED
1991693,2,9,12,6,5,23,REDACTED
1991761,1,8,10,7,4,21,REDACTED
1991761,2,4,4,5,4,13,REDACTED
1991761,3,4,5,7,4,16,REDACTED
1992966,1,7,7,2,20,29,REDACTED
1992966,2,7,17,0,3,20,REDACTED
1993019,1,19,19,12,8,39,REDACTED
1993019,2,6,8,10,6,24,REDACTED
1993019,3,6,8,9,7,24,REDACTED
1993187,1,9,10,5,7,22,REDACTED
1993187,2,9,6,8,3,17,REDACTED
1993932,1,2,3,0,3,6,REDACTED
1993932,2,0,2,0,0,2,REDACTED
1994200,1,3,15,0,0,15,REDACTED
1994200,2,3,6,16,0,22,REDACTED
1994222,1,4,2,3,0,5,REDACTED
1994222,2,11,13,5,6,24,REDACTED
1995124,1,6,4,4,3,11,REDACTED
1995231,1,2,2,2,0,4,REDACTED
1995231,2,0,0,10,0,10,REDACTED
1995231,3,2,3,4,3,10,REDACTED
1995252,1,6,8,5,5,18,REDACTED
1995252,2,2,3,2,8,13,REDACTED
1995266,1,4,3,8,3,14,REDACTED
1995266,2,5,5,2,10,17,REDACTED
1995266,3,5,6,15,16,37,REDACTED
1995279,1,9,9,4,9,22,REDACTED
1995279,2,7,6,10,9,25,REDACTED
1995585,1,5,9,1,0,10,REDACTED
1995585,2,6,7,7,6,20,REDACTED
1995830,1,5,5,3,3,11,REDACTED
1995830,2,6,7,4,3,14,REDACTED
1995975,1,2,2,6,4,12,REDACTED
1995975,2,5,5,5,4,14,REDACTED
1996296,1,2,2,3,0,5,REDACTED
1996296,2,9,11,10,0,21,REDACTED
1996507,1,2,3,5,10,18,REDACTED
1996507,2,7,9,12,24,45,REDACTED
1996770,1,0,2,0,0,2,REDACTED
1996770,2,0,0,0,0,0,REDACTED
1996884,1,4,6,3,5,14,REDACTED
1997250,1,0,0,2,11,13,REDACTED
1997446,1,4,4,4,6,14,REDACTED
1997446,2,9,7,7,3,17,REDACTED
1997768,1,4,9,6,5,20,REDACTED
1998037,1,8,12,7,20,39,REDACTED
1998286,1,9,10,10,7,27,REDACTED
1998286,2,2,3,9,4,16,REDACTED
1998312,1,2,4,2,0,6,REDACTED
1998312,2,2,3,2,0,5,REDACTED
1998704,1,3,17,7,2,26,REDACTED
1998704,2,2,3,7,2,12,REDACTED
1998704,3,2,3,2,3,8,REDACTED
1999394,1,6,12,8,10,30,REDACTED
1999394,2,0,5,4,4,13,REDACTED
1999394,3,6,11,3,15,29,REDACTED
1999732,1,0,0,0,0,0,REDACTED
1999732,2,3,3,5,0,8,REDACTED
1999732,3,1,0,0,0,0,REDACTED
1999732,4,0,9,0,0,9,REDACTED
2000040,1,4,4,2,3,9,REDACTED
2000040,2,0,0,0,0,0,REDACTED
2001499,1,3,4,9,7,20,REDACTED
2001499,2,0,0,9,2,11,REDACTED
2001537,1,4,4,8,5,17,REDACTED
2001537,2,2,5,2,2,9,REDACTED
2001921,1,9,11,4,4,19,REDACTED
2001921,2,10,11,7,7,25,REDACTED
2002018,1,5,11,8,0,19,REDACTED
2002018,2,6,11,15,9,35,REDACTED
2002018,3,6,14,8,7,29,REDACTED
2002107,1,8,3,3,10,16,REDACTED
2002107,2,8,7,7,8,22,REDACTED
2002167,1,2,2,6,0,8,REDACTED
2002217,1,22,4,10,14,28,REDACTED
2002280,1,7,1,5,8,14,REDACTED
2002280,2,2,6,6,8,20,REDACTED
2003127,1,4,8,9,2,19,REDACTED
2003127,2,4,8,5,0,13,REDACTED
2003127,3,4,8,0,0,8,REDACTED
2003127,4,5,8,0,0,8,REDACTED
2003382,1,4,2,7,4,13,REDACTED
2003382,2,7,8,8,8,24,REDACTED
2003382,4,2,2,2,2,6,REDACTED
2003721,1,2,2,9,12,23,REDACTED
2003777,1,10,10,5,0,15,REDACTED
2004574,1,4,4,5,3,12,REDACTED
2004574,2,9,12,7,13,32,REDACTED
2004789,1,6,8,9,9,26,REDACTED
2004863,1,10,15,10,9,34,REDACTED
2004863,2,3,8,16,15,39,REDACTED
2004976,1,7,3,3,3,9,REDACTED
2004976,2,14,15,6,5,26,REDACTED
2006191,1,5,9,10,7,26,REDACTED
2006421,1,0,0,0,0,0,REDACTED
2007237,1,0,0,2,7,9,REDACTED
2007237,2,2,2,2,3,7,REDACTED
2007237,4,0,0,0,3,3,REDACTED
2007245,1,0,0,0,0,0,REDACTED
2007441,1,6,8,7,3,18,REDACTED
2007441,2,5,9,10,2,21,REDACTED
2008196,1,4,4,8,5,17,REDACTED
2008196,2,6,7,4,3,14,REDACTED
2008801,1,10,21,21,33,75,REDACTED
2008801,2,5,9,2,2,13,REDACTED
2009457,1,4,9,8,0,17,REDACTED
2009457,2,8,11,6,11,28,REDACTED
2010524,1,4,6,3,4,13,REDACTED
2010685,1,14,17,0,0,17,REDACTED
2010685,2,6,8,12,5,25,REDACTED
2010685,3,5,5,2,5,12,REDACTED
2010685,4,9,16,0,14,30,REDACTED
2010685,5,6,8,8,12,28,REDACTED
2010685,6,6,15,12,11,38,REDACTED
2010685,7,0,0,0,0,0,REDACTED
2010799,1,2,8,11,5,24,REDACTED
2010799,2,2,8,10,0,18,REDACTED
2011024,1,7,9,0,0,9,REDACTED
2012384,1,7,5,0,0,5,REDACTED
2012384,2,3,3,0,0,3,REDACTED
2013266,1,7,5,1,0,6,REDACTED
2013331,1,0,10,25,16,51,REDACTED
2013442,1,3,3,1,6,10,REDACTED
2013442,2,0,0,0,0,0,REDACTED
2013827,1,10,10,15,8,33,REDACTED
2013827,2,6,7,11,6,24,REDACTED
2013968,1,8,7,8,0,15,REDACTED
2014183,1,10,10,2,6,18,REDACTED
2014183,2,11,11,2,5,18,REDACTED
2014238,1,8,9,6,11,26,REDACTED
2014396,1,8,8,4,6,18,REDACTED
2014396,2,7,10,7,10,27,REDACTED
2014948,1,4,4,6,7,17,REDACTED
2014948,2,7,5,6,3,14,REDACTED
2014949,1,7,7,3,17,27,REDACTED
2015280,1,8,6,5,4,15,REDACTED
2015280,2,15,2,6,8,16,REDACTED
2015371,1,5,4,4,3,11,REDACTED
2015371,2,6,0,8,1,9,REDACTED
2015371,3,4,4,6,0,10,REDACTED
2015371,4,4,5,4,0,9,REDACTED
2016874,1,9,14,7,6,27,REDACTED
2016874,2,4,6,7,3,16,REDACTED
2017561,1,4,3,8,0,11,REDACTED
2017561,2,4,3,2,2,7,REDACTED
2017885,1,6,12,10,5,27,REDACTED
2017885,2,2,2,5,6,13,REDACTED
2019292,1,7,18,8,7,33,REDACTED
2019292,2,7,20,2,3,25,REDACTED
2019713,1,3,6,0,0,6,REDACTED
2019713,2,0,0,0,0,0,REDACTED
2019713,3,2,0,0,0,0,REDACTED
2020057,1,2,1,13,0,14,REDACTED
2020057,2,2,2,6,0,8,REDACTED
2020552,1,7,7,8,2,17,REDACTED
2020552,2,0,0,4,6,10,REDACTED
2020886,1,4,4,3,7,14,REDACTED
2020886,2,6,6,8,2,16,REDACTED
2020889,1,12,7,7,6,20,REDACTED
2020889,2,11,7,2,1,10,REDACTED
2021002,1,4,3,14,3,20,REDACTED
2021002,2,11,15,13,7,35,REDACTED
2021002,3,11,11,6,3,20,REDACTED
2021009,1,4,1,0,0,1,REDACTED
2021009,2,9,19,6,15,40,REDACTED
2021256,1,3,3,2,0,5,REDACTED
2021256,2,12,9,14,7,30,REDACTED
2021256,3,5,5,10,0,15,REDACTED
2021256,4,2,4,0,0,4,REDACTED
2021375,1,4,5,8,3,16,REDACTED
2021375,2,8,8,3,2,13,REDACTED
2022046,1,4,4,8,14,26,REDACTED
2022046,2,6,10,10,0,20,REDACTED
2022046,3,9,8,8,9,25,REDACTED
2022134,1,8,5,0,4,9,REDACTED
2022134,2,3,10,0,10,20,REDACTED
2022431,1,2,2,2,2,6,REDACTED
2022431,2,0,0,0,0,0,REDACTED
2022431,3,2,13,15,15,43,REDACTED
2022720,1,4,4,10,3,17,REDACTED
2022720,2,8,8,13,4,25,REDACTED
2022720,3,0,0,0,0,0,REDACTED
2022720,4,3,5,0,0,5,REDACTED
2022806,1,7,8,0,11,19,REDACTED
2022827,1,6,5,8,7,20,REDACTED
2022827,2,4,3,6,4,13,REDACTED
2023097,1,9,13,12,0,25,REDACTED
2023097,2,9,12,13,0,25,REDACTED
2023097,3,4,8,0,0,8,REDACTED
2023645,1,5,4,2,0,6,REDACTED
2024088,1,0,0,1,9,10,REDACTED
2024088,2,0,0,2,9,11,REDACTED
2024103,1,2,2,5,8,15,REDACTED
2024103,2,7,16,21,8,45,REDACTED
2024417,1,0,0,18,10,28,REDACTED
2024417,2,0,0,6,5,11,REDACTED
2024493,1,10,9,9,15,33,REDACTED
2024493,2,3,2,8,9,19,REDACTED
2024494,1,5,8,3,5,16,REDACTED
2024494,2,5,8,8,5,21,REDACTED
2025090,1,7,8,4,5,17,REDACTED
2025090,2,8,8,1,4,13,REDACTED
2025090,3,8,24,9,5,38,REDACTED
2025270,1,9,9,0,2,11,REDACTED
2025270,2,4,3,5,12,20,REDACTED
2027342,1,13,14,7,8,29,REDACTED
2027390,1,4,5,11,0,16,REDACTED
2028330,1,0,0,0,0,0,REDACTED
2028330,2,0,0,0,0,0,REDACTED
2028610,1,11,16,5,1,22,REDACTED
2028610,2,11,6,2,1,9,REDACTED
2028610,3,11,13,2,0,15,REDACTED
2028610,4,10,13,5,0,18,REDACTED
2039824,1,8,3,4,0,7,REDACTED
2039824,2,2,2,5,2,9,REDACTED
2042967,1,7,10,0,0,10,REDACTED
2042967,2,4,4,5,0,9,REDACTED
2044278,1,3,6,1,6,13,REDACTED
2044278,2,4,6,5,6,17,REDACTED
2045693,1,11,4,0,3,7,REDACTED
2045693,2,11,11,3,7,21,REDACTED
2046577,1,2,5,7,5,17,REDACTED
2046577,2,14,17,15,12,44,REDACTED
2051970,1,4,6,0,2,8,REDACTED
2051970,2,9,10,5,5,20,REDACTED
2052069,1,4,4,2,9,15,REDACTED
2052821,1,4,5,4,6,15,REDACTED
2052821,2,8,8,10,12,30,REDACTED
2054493,1,6,7,5,4,16,REDACTED
2054718,1,3,3,3,6,12,REDACTED
2054718,2,3,4,7,4,15,REDACTED
2058384,1,5,4,5,1,10,REDACTED
2060863,1,11,6,4,8,18,REDACTED
2060901,1,2,2,1,0,3,REDACTED
2061905,1,5,8,0,0,8,REDACTED
2061905,2,0,0,0,0,0,REDACTED
2066556,1,4,0,4,3,7,REDACTED
2066556,2,0,0,0,0,0,REDACTED
2066556,3,4,15,14,0,29,REDACTED
2066622,2,2,2,0,6,8,REDACTED
2068649,1,4,4,9,5,18,REDACTED
2077130,1,3,3,4,2,9,REDACTED
2078526,1,2,2,0,0,2,REDACTED
2078526,2,0,0,0,0,0,REDACTED
2078607,1,4,5,5,5,15,REDACTED
2081560,1,3,3,2,3,8,REDACTED
2085953,1,10,9,5,3,17,REDACTED
2085953,2,5,3,2,5,10,REDACTED
2086017,1,6,8,8,6,22,REDACTED
2086017,2,2,2,9,7,18,REDACTED
2090898,1,5,5,2,9,16,REDACTED
2090898,2,7,3,6,8,17,REDACTED
2090898,3,8,9,7,11,27,REDACTED
2102240,1,4,8,3,5,16,REDACTED
2102240,2,5,3,0,5,8,REDACTED
2103160,1,2,3,1,4,8,REDACTED
2106883,1,16,15,10,9,34,REDACTED
2106883,2,9,9,15,7,31,REDACTED
2108917,1,6,7,4,7,18,REDACTED
2108917,2,3,3,3,4,10,REDACTED
2109025,1,11,12,0,0,12,REDACTED
2109025,2,2,7,0,0,7,REDACTED
2109188,1,4,5,9,0,14,REDACTED
2110511,1,5,9,0,0,9,REDACTED
2110511,2,1,0,0,0,0,REDACTED
2110511,3,5,9,7,0,16,REDACTED
2111012,1,12,12,16,0,28,REDACTED
2111012,2,6,18,13,0,31,REDACTED
2114027,1,7,2,0,0,2,REDACTED
2115859,1,6,6,5,4,15,REDACTED
2115859,2,6,6,4,0,10,REDACTED
2120309,1,5,5,5,8,18,REDACTED
2120464,1,3,3,0,0,3,REDACTED
2120464,2,3,5,0,0,5,REDACTED
2120738,1,4,4,2,8,14,REDACTED
2120738,2,4,9,0,0,9,REDACTED
2120815,1,4,4,11,4,19,REDACTED
2120836,1,7,7,3,5,15,REDACTED
2120851,1,3,3,4,0,7,REDACTED
2120851,2,4,7,0,4,11,REDACTED
2120881,1,2,2,8,12,22,REDACTED
2120881,2,3,3,4,2,9,REDACTED
2120897,1,4,4,2,8,14,REDACTED
2120897,2,4,7,3,4,14,REDACTED
2120966,1,10,12,3,0,15,REDACTED
2121029,1,0,0,2,0,2,REDACTED
2121029,2,4,5,0,0,5,REDACTED
2121651,1,4,7,0,9,16,REDACTED
2121651,2,8,4,2,0,6,REDACTED
2121657,1,5,9,4,6,19,REDACTED
2121657,2,2,6,8,0,14,REDACTED
2121960,1,9,11,8,13,32,REDACTED
2121960,2,7,5,3,7,15,REDACTED
2122181,1,9,11,9,9,29,REDACTED
2122181,2,0,0,0,0,0,REDACTED
2122181,3,4,1,8,1,10,REDACTED
2122496,1,10,11,10,17,38,REDACTED
2122496,2,7,7,10,10,27,REDACTED
2122541,1,6,6,0,0,6,REDACTED
2122541,2,6,4,0,0,4,REDACTED
2122901,1,6,10,7,1,18,REDACTED
2122901,2,7,6,5,0,11,REDACTED
2122901,3,6,6,0,0,6,REDACTED
2122901,4,7,7,0,0,7,REDACTED
2123256,1,2,3,10,3,16,REDACTED
2123256,2,2,3,2,0,5,REDACTED
2123868,1,7,8,9,8,25,REDACTED
2123991,1,0,0,5,5,10,REDACTED
2123991,2,6,2,4,3,9,REDACTED
2128787,1,4,3,3,12,18,REDACTED
2128787,2,4,6,6,7,19,REDACTED
2133573,1,2,2,8,4,14,REDACTED
2133573,2,6,11,9,4,24,REDACTED
2134108,1,10,4,0,0,4,REDACTED
2134108,2,8,8,0,3,11,REDACTED
2134726,1,6,6,6,5,17,REDACTED
2134726,2,13,11,2,16,29,REDACTED
2138614,1,11,9,6,0,15,REDACTED
2138817,1,0,0,8,0,8,REDACTED
2138817,2,0,0,5,0,5,REDACTED
2138817,3,0,0,0,9,9,REDACTED
2138817,4,0,0,0,7,7,REDACTED
2138817,5,2,2,0,12,14,REDACTED
2138817,6,0,0,0,13,13,REDACTED
2139926,1,9,15,3,4,22,REDACTED
2140600,1,3,5,7,7,19,REDACTED
2140600,2,3,4,0,0,4,REDACTED
2141589,1,5,5,0,6,11,REDACTED
2141589,2,0,0,0,9,9,REDACTED
2143117,1,12,15,12,11,38,REDACTED
2143117,2,7,8,5,7,20,REDACTED
2143117,3,8,8,10,6,24,REDACTED
2143512,1,4,7,7,4,18,REDACTED
2143512,2,2,3,6,2,11,REDACTED
2149334,1,2,2,2,1,5,REDACTED
2149334,2,3,5,7,0,12,REDACTED
2149479,1,6,6,0,0,6,REDACTED
2151428,1,3,4,6,23,33,REDACTED
2153078,1,6,7,0,8,15,REDACTED
2153078,2,5,6,7,4,17,REDACTED
2159781,1,3,3,11,8,22,REDACTED
2159781,2,3,5,3,8,16,REDACTED
2160607,1,10,10,33,25,68,REDACTED
2161303,1,7,7,6,0,13,REDACTED
2161303,2,4,4,7,6,17,REDACTED
2161748,1,8,4,0,0,4,REDACTED
2161748,2,8,12,5,4,21,REDACTED
2161939,1,3,3,0,4,7,REDACTED
2165500,1,6,4,5,0,9,REDACTED
2165500,2,4,4,9,0,13,REDACTED
2166694,1,4,4,5,4,13,REDACTED
2166694,2,0,0,6,4,10,REDACTED
2168031,1,3,3,6,23,32,REDACTED
2168031,2,3,3,8,20,31,REDACTED
2169173,1,3,5,6,4,15,REDACTED
2170291,1,0,0,0,0,0,REDACTED
2170291,2,0,0,0,0,0,REDACTED
2173121,2,0,0,0,0,0,REDACTED
2173121,3,0,0,0,0,0,REDACTED
2173121,4,0,0,0,0,0,REDACTED
2177363,1,7,8,5,9,22,REDACTED
2177363,2,0,0,0,9,9,REDACTED
2177363,3,2,3,2,9,14,REDACTED
2177498,1,3,5,7,5,17,REDACTED
2177498,2,3,3,10,6,19,REDACTED
2178078,1,2,2,4,4,10,REDACTED
2178078,2,2,1,0,0,1,REDACTED
2178229,1,4,4,5,13,22,REDACTED
2178229,2,0,0,4,13,17,REDACTED
2179962,1,5,2,3,0,5,REDACTED
2180129,1,8,6,6,0,12,REDACTED
2180129,2,4,2,0,0,2,REDACTED
2189089,1,9,9,9,7,25,REDACTED
2189089,2,5,4,3,4,11,REDACTED
2189597,1,4,1,8,3,12,REDACTED
2189597,2,2,8,6,14,28,REDACTED
2189597,4,4,8,5,3,16,REDACTED
2189705,1,4,3,7,7,17,REDACTED
2189705,2,5,7,5,5,17,REDACTED
2198082,1,2,1,0,4,5,REDACTED
2198082,2,0,0,0,6,6,REDACTED
2198082,3,0,0,0,0,0,REDACTED
2198130,1,0,0,6,7,13,REDACTED
2198845,1,6,4,6,8,18,REDACTED
2198845,2,5,8,6,8,22,REDACTED
2199388,1,4,3,3,4,10,REDACTED
2201184,1,8,7,8,9,24,REDACTED
2201184,2,6,7,9,11,27,REDACTED
2201678,1,2,4,3,3,10,REDACTED
2201678,2,5,5,3,2,10,REDACTED
2201810,1,11,10,16,0,26,REDACTED
2201810,2,9,6,15,0,21,REDACTED
2201852,1,9,10,2,4,16,REDACTED
2201868,1,11,6,11,3,20,REDACTED
2201912,1,8,10,0,0,10,REDACTED
2201912,2,13,11,0,0,11,REDACTED
2201931,1,3,3,6,0,9,REDACTED
2201957,1,5,4,1,17,22,REDACTED
2202072,1,7,11,4,9,24,REDACTED
2202072,2,7,10,9,16,35,REDACTED
2202418,1,6,3,0,2,5,REDACTED
2202418,2,6,6,0,2,8,REDACTED
2202497,1,8,13,10,0,23,REDACTED
2202497,2,13,14,7,0,21,REDACTED
2202611,1,7,8,6,0,14,REDACTED
2202611,2,9,10,3,2,15,REDACTED
2202875,1,12,11,0,0,11,REDACTED
2203197,1,10,13,12,16,41,REDACTED
2203197,2,0,0,0,0,0,REDACTED
2203247,1,8,8,5,0,13,REDACTED
2203247,2,12,13,2,4,19,REDACTED
2203381,1,8,12,7,1,20,REDACTED
2203381,2,2,3,2,11,16,REDACTED
2203391,1,9,12,8,13,33,REDACTED
2203501,1,4,4,3,4,11,REDACTED
2203666,1,9,10,20,6,36,REDACTED
2203687,1,4,7,3,4,14,REDACTED
2203687,2,9,8,5,13,26,REDACTED
2204109,1,7,6,7,3,16,REDACTED
2204109,2,7,5,0,0,5,REDACTED
2204161,1,10,4,4,3,11,REDACTED
2204161,2,0,0,9,16,25,REDACTED
2204161,3,8,8,9,7,24,REDACTED
2204161,4,4,4,3,3,10,REDACTED
2204184,1,13,8,7,5,20,REDACTED
2204184,2,6,11,11,11,33,REDACTED
2204247,1,4,5,6,8,19,REDACTED
2204247,2,9,13,9,8,30,REDACTED
2204408,1,0,0,9,11,20,REDACTED
2204408,2,0,0,0,30,30,REDACTED
2205630,1,19,26,4,0,30,REDACTED
2205630,2,6,6,0,0,6,REDACTED
2205630,3,12,14,0,0,14,REDACTED
2205630,4,12,18,0,0,18,REDACTED
2210532,1,2,4,10,5,19,REDACTED
2210532,2,7,8,7,2,17,REDACTED
2210532,3,4,5,5,0,10,REDACTED
2210532,4,3,9,18,10,37,REDACTED
2213603,1,4,8,7,8,23,REDACTED
2218838,1,5,6,6,0,12,REDACTED
2218838,2,5,8,5,0,13,REDACTED
2220815,1,7,14,1,9,24,REDACTED
2220815,2,7,13,2,9,24,REDACTED
2225713,1,6,3,17,0,20,REDACTED
2225713,2,4,4,0,0,4,REDACTED
2226342,1,9,11,8,6,25,REDACTED
2226342,2,12,2,7,12,21,REDACTED
2226384,1,4,6,12,22,40,REDACTED
2226384,2,5,5,4,8,17,REDACTED
2226734,1,7,6,7,10,23,REDACTED
2226734,2,8,9,9,11,29,REDACTED
2226734,3,6,8,10,10,28,REDACTED
2226928,1,15,27,17,20,64,REDACTED
2226928,2,0,0,8,11,19,REDACTED
2227129,1,6,7,12,19,38,REDACTED
2227309,1,4,5,10,2,17,REDACTED
2227309,2,1,1,9,0,10,REDACTED
2227325,1,7,7,3,2,12,REDACTED
2227325,2,5,6,3,5,14,REDACTED
2227325,3,3,3,9,1,13,REDACTED
2227325,4,12,19,9,0,28,REDACTED
2227498,1,6,6,4,5,15,REDACTED
2227499,1,4,4,5,5,14,REDACTED
2227913,1,6,9,11,3,23,REDACTED
2227913,2,2,2,2,2,6,REDACTED
2227918,1,6,5,6,7,18,REDACTED
2227918,2,2,3,5,3,11,REDACTED
2227954,1,3,2,2,6,10,REDACTED
2227954,2,5,6,1,1,8,REDACTED
2228028,1,2,2,5,0,7,REDACTED
2228028,2,4,4,4,0,8,REDACTED
2228569,1,0,0,3,10,13,REDACTED
2228569,2,6,4,3,4,11,REDACTED
2229139,1,7,7,5,6,18,REDACTED
2229139,2,7,7,10,7,24,REDACTED
2229194,1,3,3,6,2,11,REDACTED
2229194,2,2,2,7,2,11,REDACTED
2229219,1,5,8,4,0,12,REDACTED
2229219,2,4,6,7,4,17,REDACTED
2229255,1,5,5,2,5,12,REDACTED
2229255,2,3,3,0,5,8,REDACTED
2229464,1,7,7,7,17,31,REDACTED
2229509,1,2,2,10,4,16,REDACTED
2230482,1,2,4,10,0,14,REDACTED
2230482,2,5,10,11,0,21,REDACTED
2231832,1,9,11,20,6,37,REDACTED
2231832,2,6,9,15,6,30,REDACTED
2231974,1,4,4,6,7,17,REDACTED
2231974,2,2,2,0,4,6,REDACTED
2231979,1,0,0,2,5,7,REDACTED
2232247,1,5,5,5,5,15,REDACTED
2232461,1,5,12,9,5,26,REDACTED
2232461,2,7,9,11,11,31,REDACTED
2232461,3,10,12,9,11,32,REDACTED
2232719,1,9,9,12,7,28,REDACTED
2232719,2,5,5,4,2,11,REDACTED
2232765,1,3,5,2,6,13,REDACTED
2232765,2,4,4,5,4,13,REDACTED
2232877,1,2,2,4,2,8,REDACTED
2232877,2,2,2,3,0,5,REDACTED
2234135,1,7,7,10,5,22,REDACTED
2239086,1,5,2,8,5,15,REDACTED
2239162,1,2,2,6,5,13,REDACTED
2239184,1,8,8,5,7,20,REDACTED
2239184,2,6,7,2,5,14,REDACTED
2239342,1,4,1,2,6,9,REDACTED
2239342,2,6,7,11,6,24,REDACTED
2239385,1,4,5,1,2,8,REDACTED
2239385,2,6,4,0,2,6,REDACTED
2239477,1,8,9,13,10,32,REDACTED
2239536,1,5,2,9,5,16,REDACTED
2239536,2,0,0,0,2,2,REDACTED
2239728,1,6,9,14,10,33,REDACTED
2239728,2,5,7,7,6,20,REDACTED
2239969,1,8,8,7,9,24,REDACTED
2239969,2,6,7,2,4,13,REDACTED
2240431,1,3,3,1,0,4,REDACTED
2240464,1,5,8,7,6,21,REDACTED
2240464,2,5,5,15,9,29,REDACTED
2240492,1,5,5,4,11,20,REDACTED
2240800,1,6,6,14,0,20,REDACTED
2240800,2,8,8,11,0,19,REDACTED
2241284,1,11,9,5,7,21,REDACTED
2241284,2,6,6,2,4,12,REDACTED
2241355,1,6,6,8,4,18,REDACTED
2241355,2,4,11,15,2,28,REDACTED
2241496,1,5,6,6,10,22,REDACTED
2241726,1,5,7,12,22,41,REDACTED
2241936,1,6,6,8,2,16,REDACTED
2241936,2,6,8,2,2,12,REDACTED
2241982,1,4,7,5,8,20,REDACTED
2242206,1,3,3,7,1,11,REDACTED
2242206,2,5,5,1,7,13,REDACTED
2242251,1,2,2,1,5,8,REDACTED
2242251,2,2,2,1,5,8,REDACTED
2242812,1,2,9,4,4,17,REDACTED
2242812,2,4,4,4,0,8,REDACTED
2242838,1,0,0,0,0,0,REDACTED
2242838,2,2,14,11,6,31,REDACTED
2242861,1,4,5,4,5,14,REDACTED
2243183,1,4,6,6,3,15,REDACTED
2243183,2,6,7,11,3,21,REDACTED
2243505,1,3,3,9,8,20,REDACTED
2243505,2,8,8,6,8,22,REDACTED
2243827,1,2,2,4,0,6,REDACTED
2243827,2,0,0,6,0,6,REDACTED
2243972,1,4,8,0,0,8,REDACTED
2244321,1,3,3,7,5,15,REDACTED
2244321,2,2,3,0,2,5,REDACTED
2245486,1,5,5,6,4,15,REDACTED
2245751,1,6,7,4,18,29,REDACTED
2246501,1,6,6,14,13,33,REDACTED
2246501,2,7,7,5,6,18,REDACTED
2246501,3,6,17,10,0,27,REDACTED
2247265,1,8,10,3,0,13,REDACTED
2247265,2,4,4,20,7,31,REDACTED
2247760,1,8,15,5,2,22,REDACTED
2248417,1,8,8,6,8,22,REDACTED
2248417,2,6,1,3,2,6,REDACTED
2249463,1,4,6,7,9,22,REDACTED
2249511,1,5,2,7,5,14,REDACTED
2249511,2,5,2,5,2,9,REDACTED
2254056,1,8,9,19,5,33,REDACTED
2254056,2,2,5,4,6,15,REDACTED
2254256,1,8,7,0,7,14,REDACTED
2254256,2,2,2,5,5,12,REDACTED
2254924,1,2,2,2,2,6,REDACTED
2254924,2,3,10,8,4,22,REDACTED
2254943,1,5,9,0,9,18,REDACTED
2254955,1,4,4,6,11,21,REDACTED
2254955,2,8,2,2,6,10,REDACTED
2255154,1,3,12,13,8,33,REDACTED
2255154,2,3,6,2,8,16,REDACTED
2255154,3,4,0,0,0,0,REDACTED
2256477,1,2,2,0,0,2,REDACTED
2256662,1,0,0,0,0,0,REDACTED
2256662,2,0,0,0,0,0,REDACTED
2256736,1,5,7,6,4,17,REDACTED
2256820,1,4,6,4,4,14,REDACTED
2256820,2,3,5,3,4,12,REDACTED
2256825,1,5,8,6,5,19,REDACTED
2256825,2,3,5,0,0,5,REDACTED
2256904,1,0,0,3,0,3,REDACTED
2256904,2,5,5,0,5,10,REDACTED
2256904,3,4,9,7,5,21,REDACTED
2257216,1,14,20,18,11,49,REDACTED
2257216,2,2,4,8,2,14,REDACTED
2257216,3,10,8,0,0,8,REDACTED
2257227,1,8,17,10,0,27,REDACTED
2257227,2,3,3,4,3,10,REDACTED
2258254,1,8,6,6,8,20,REDACTED
2258254,2,4,6,2,5,13,REDACTED
2258542,1,3,5,7,3,15,REDACTED
2258542,2,4,7,6,7,20,REDACTED
2258542,3,8,8,5,2,15,REDACTED
2258542,4,5,5,0,3,8,REDACTED
2258654,1,6,6,8,5,19,REDACTED
2258654,2,13,11,5,2,18,REDACTED
2258854,1,11,12,16,18,46,REDACTED
2258854,2,6,10,5,9,24,REDACTED
2258866,1,8,5,19,19,43,REDACTED
2258866,2,13,19,3,4,26,REDACTED
2258866,3,15,15,15,9,39,REDACTED
2259284,1,5,5,5,3,13,REDACTED
2259284,2,13,13,8,8,29,REDACTED
2259385,1,12,12,9,5,26,REDACTED
2259385,2,5,4,9,6,19,REDACTED
2259588,1,5,5,6,0,11,REDACTED
2259665,1,4,4,7,12,23,REDACTED
2259665,2,6,3,2,9,14,REDACTED
2259847,1,4,5,3,1,9,REDACTED
2259847,2,4,4,1,6,11,REDACTED
2259847,3,6,5,2,4,11,REDACTED
2260006,1,4,4,2,6,12,REDACTED
2260006,2,7,10,12,5,27,REDACTED
2260076,1,15,16,8,8,32,REDACTED
2260089,1,8,11,6,8,25,REDACTED
2260089,2,8,3,11,10,24,REDACTED
2260709,1,4,5,1,0,6,REDACTED
2260709,2,6,5,1,0,6,REDACTED
2261150,1,5,14,3,14,31,REDACTED
2262076,1,4,6,4,0,10,REDACTED
2262076,2,2,2,7,12,21,REDACTED
2262084,1,4,5,5,0,10,REDACTED
2262084,2,0,0,4,2,6,REDACTED
2262205,1,2,3,2,0,5,REDACTED
2262248,1,7,14,13,9,36,REDACTED
2262435,1,6,2,4,0,6,REDACTED
2262971,1,5,3,3,0,6,REDACTED
2262971,2,8,12,2,8,22,REDACTED
2263133,1,8,8,6,5,19,REDACTED
2263133,2,2,2,39,4,45,REDACTED
2264181,1,9,21,3,0,24,REDACTED
2264181,2,9,20,0,1,21,REDACTED
2270913,1,6,6,10,4,20,REDACTED
2270913,2,7,7,10,3,20,REDACTED
2281181,1,9,8,1,0,9,REDACTED
2281181,2,3,3,10,6,19,REDACTED
2281181,4,0,0,0,0,0,REDACTED
2283119,1,4,4,12,4,20,REDACTED
2285494,1,7,11,17,12,40,REDACTED
2285494,2,4,6,6,1,13,REDACTED
2285494,3,6,3,0,6,9,REDACTED
2285494,4,4,6,7,0,13,REDACTED
2287241,1,5,6,0,0,6,REDACTED
2287241,2,3,3,3,4,10,REDACTED
2289321,1,3,3,3,5,11,REDACTED
2295792,1,4,2,11,2,15,REDACTED
2295946,1,0,0,0,0,0,REDACTED
2480848,1,4,4,3,2,9,REDACTED
2480848,2,11,13,18,21,52,REDACTED
2481805,1,6,14,6,5,25,REDACTED
2481805,2,3,1,2,1,4,REDACTED
2481805,3,3,1,1,3,5,REDACTED
2481805,5,4,0,0,0,0,REDACTED
2482036,1,8,17,9,14,40,REDACTED
2482036,2,0,0,5,0,5,REDACTED
2482036,3,3,6,0,10,16,REDACTED
2482232,1,4,5,3,0,8,REDACTED
2482232,2,6,4,3,1,8,REDACTED
2482232,3,3,7,4,0,11,REDACTED
2482232,4,4,6,2,6,14,REDACTED
2482232,5,5,5,1,5,11,REDACTED
2482355,1,4,4,5,0,9,REDACTED
2482355,2,5,5,4,2,11,REDACTED
2482588,1,9,10,8,0,18,REDACTED
2482588,2,6,6,4,10,20,REDACTED
2482955,1,6,0,0,0,0,REDACTED
2482955,2,0,0,9,9,18,REDACTED
2482955,3,0,0,0,0,0,REDACTED
2483036,1,0,0,6,1,7,REDACTED
2483036,2,0,0,5,2,7,REDACTED
2483117,1,8,9,1,2,12,REDACTED
2483117,2,4,4,6,8,18,REDACTED
2483117,3,3,5,0,1,6,REDACTED
2483211,1,4,4,0,0,4,REDACTED
2483211,2,2,2,7,8,17,REDACTED
2483437,1,6,7,4,3,14,REDACTED
2483437,2,5,10,10,6,26,REDACTED
2483437,3,2,9,1,9,19,REDACTED
2483647,1,9,11,7,7,25,REDACTED
2483965,1,3,6,2,6,14,REDACTED
2483965,2,4,1,16,6,23,REDACTED
2483965,3,2,3,2,0,5,REDACTED
2483965,4,4,7,5,0,12,REDACTED
2484005,1,0,0,0,0,0,REDACTED
2484005,2,4,1,6,1,8,REDACTED
2484282,1,2,2,5,3,10,REDACTED
2484282,2,5,6,5,4,15,REDACTED
2484878,1,8,10,6,11,27,REDACTED
2484878,2,5,4,5,12,21,REDACTED
2484936,1,0,0,0,0,0,REDACTED
2484936,2,0,0,0,2,2,REDACTED
2485351,1,7,7,14,2,23,REDACTED
2485351,2,5,5,4,0,9,REDACTED
2485351,3,5,3,0,0,3,REDACTED
2485351,4,6,10,0,0,10,REDACTED
2485452,1,4,4,4,16,24,REDACTED
2485452,2,12,13,6,8,27,REDACTED
2485713,1,6,5,12,9,26,REDACTED
2485810,1,1,2,2,2,6,REDACTED
2485810,2,0,0,0,0,0,REDACTED
2486483,1,7,7,2,7,16,REDACTED
2486529,1,2,3,9,6,18,REDACTED
2486529,2,0,0,2,16,18,REDACTED
2486529,3,2,6,0,10,16,REDACTED
2486789,1,11,6,9,12,27,REDACTED
2486789,2,7,12,1,2,15,REDACTED
2486990,1,5,7,7,1,15,REDACTED
2486990,2,4,5,4,1,10,REDACTED
2486990,3,4,8,4,0,12,REDACTED
2487841,1,0,0,0,0,0,REDACTED
2487841,2,2,2,2,0,4,REDACTED
2487841,3,2,2,1,0,3,REDACTED
2488186,1,0,0,2,5,7,REDACTED
2488186,2,2,2,5,4,11,REDACTED
2488186,3,0,0,6,3,9,REDACTED
2489387,1,8,7,2,7,16,REDACTED
2489387,2,11,9,12,9,30,REDACTED
2489387,3,0,13,2,7,22,REDACTED
2489387,4,3,5,5,0,10,REDACTED
2489387,5,2,2,2,5,9,REDACTED
2490004,1,4,2,2,1,5,REDACTED
2490004,2,3,3,1,0,4,REDACTED
2490004,3,3,6,15,5,26,REDACTED
2490249,1,4,4,3,0,7,REDACTED
2490249,2,4,5,2,0,7,REDACTED
2490412,1,8,8,0,4,12,REDACTED
2490412,2,2,2,0,0,2,REDACTED
2491171,1,8,10,0,0,10,REDACTED
2491171,2,2,4,0,0,4,REDACTED
2491171,3,12,14,0,0,14,REDACTED
2491179,1,10,11,13,13,37,REDACTED
2491179,2,4,2,6,6,14,REDACTED
2491179,3,0,7,2,0,9,REDACTED
2492330,1,2,3,6,8,17,REDACTED
2492330,2,4,3,1,0,4,REDACTED
2492330,3,4,5,9,0,14,REDACTED
2492629,1,3,10,18,9,37,REDACTED
2492629,2,4,4,8,7,19,REDACTED
2493000,1,4,4,2,2,8,REDACTED
2493000,2,4,5,11,9,25,REDACTED
2493109,1,5,5,7,4,16,REDACTED
2493109,2,5,2,3,0,5,REDACTED
2494033,1,2,2,7,5,14,REDACTED
2494033,2,5,3,2,2,7,REDACTED
2494033,3,2,3,2,6,11,REDACTED
2494270,1,8,5,1,8,14,REDACTED
2494270,2,5,6,0,9,15,REDACTED
2494273,1,4,21,40,27,88,REDACTED
2494273,2,0,0,0,0,0,REDACTED
2494273,3,3,3,7,5,15,REDACTED
2494273,4,11,5,5,0,10,REDACTED
2494308,1,10,9,0,0,9,REDACTED
2494520,1,0,0,16,18,34,REDACTED
2494520,2,14,18,0,0,18,REDACTED
2494973,1,7,10,5,0,15,REDACTED
2494973,2,4,2,4,2,8,REDACTED
2494973,3,2,0,0,0,0,REDACTED
2494973,4,3,0,0,0,0,REDACTED
2494973,5,2,0,0,0,0,REDACTED
2496409,1,0,0,10,0,10,REDACTED
2496741,1,6,5,9,16,30,REDACTED
2496741,2,13,13,13,14,40,REDACTED
2496741,3,4,10,8,9,27,REDACTED
2496884,1,0,0,0,3,3,REDACTED
2496884,2,7,7,3,6,16,REDACTED
2496890,1,0,25,16,17,58,REDACTED
2496890,2,0,22,19,16,57,REDACTED
2497068,1,1,12,0,0,12,REDACTED
2497068,2,1,6,0,0,6,REDACTED
2497454,1,12,15,22,16,53,REDACTED
2497454,2,4,15,3,11,29,REDACTED
2497982,1,4,7,13,2,22,REDACTED
2497982,2,6,1,5,0,6,REDACTED
2498152,1,4,7,0,0,7,REDACTED
2498152,2,2,0,0,0,0,REDACTED
2498152,3,2,2,0,0,2,REDACTED
2498898,1,5,4,8,10,22,REDACTED
2498898,2,0,0,0,0,0,REDACTED
2498898,3,5,9,6,5,20,REDACTED
2499407,1,0,0,0,0,0,REDACTED
2499407,2,0,0,0,0,0,REDACTED
2499407,3,0,0,0,0,0,REDACTED
2499407,4,0,0,0,0,0,REDACTED
2499407,5,0,0,0,0,0,REDACTED
2499407,6,0,0,0,0,0,REDACTED
2499407,7,0,0,0,0,0,REDACTED
2499407,8,0,0,0,0,0,REDACTED
2500170,1,3,2,4,4,10,REDACTED
2500170,2,5,3,0,2,5,REDACTED
2500170,3,9,10,0,6,16,REDACTED
2500170,4,0,0,0,6,6,REDACTED
2500429,1,6,0,0,0,0,REDACTED
2500429,2,7,8,0,0,8,REDACTED
2500429,3,5,6,0,0,6,REDACTED
2500429,4,4,4,0,0,4,REDACTED
2500521,1,4,10,11,1,22,REDACTED
2500521,2,3,3,7,8,18,REDACTED
2500891,1,6,5,4,5,14,REDACTED
2500891,2,3,3,2,4,9,REDACTED
2501084,1,5,4,3,4,11,REDACTED
2501084,2,8,8,0,3,11,REDACTED
2501198,1,6,4,2,6,12,REDACTED
2501198,2,6,7,5,6,18,REDACTED
2501198,3,4,8,2,0,10,REDACTED
2501227,1,7,13,5,8,26,REDACTED
2501227,2,4,2,3,10,15,REDACTED
2503260,1,7,9,11,8,28,REDACTED
2503260,2,0,0,6,3,9,REDACTED
2503260,3,6,0,0,7,7,REDACTED
2503307,1,4,4,7,4,15,REDACTED
2503307,2,5,6,13,4,23,REDACTED
2504324,1,2,3,3,2,8,REDACTED
2504324,2,0,0,0,0,0,REDACTED
2504556,1,8,9,2,10,21,REDACTED
2504556,2,5,7,6,0,13,REDACTED
2504989,1,2,10,3,0,13,REDACTED
2504989,2,2,3,2,2,7,REDACTED
2505116,1,4,4,3,8,15,REDACTED
2505116,2,0,0,0,5,5,REDACTED
2505116,3,5,6,9,7,22,REDACTED
2505607,1,4,5,8,6,19,REDACTED
2505607,2,10,10,12,10,32,REDACTED
2505607,3,0,0,0,0,0,REDACTED
2505607,4,4,6,4,2,12,REDACTED
2505817,1,2,1,3,1,5,REDACTED
2505817,2,0,0,0,0,0,REDACTED
2505817,3,0,0,0,0,0,REDACTED
2506122,1,3,3,9,7,19,REDACTED
2506122,2,3,8,4,8,20,REDACTED
2506252,1,14,4,2,3,9,REDACTED
2506252,2,0,0,5,11,16,REDACTED
2506460,1,16,19,10,6,35,REDACTED
2506460,2,0,0,0,1,1,REDACTED
2506471,1,4,6,5,7,18,REDACTED
2506471,2,2,2,1,0,3,REDACTED
2506471,3,2,3,0,2,5,REDACTED
2506589,1,2,2,2,5,9,REDACTED
2506589,2,4,11,2,17,30,REDACTED
2506589,3,9,14,15,0,29,REDACTED
2506684,1,0,0,0,1,1,REDACTED
2506684,2,2,4,5,7,16,REDACTED
2506684,3,7,7,4,5,16,REDACTED
2506684,4,11,7,22,0,29,REDACTED
2507323,1,2,3,5,4,12,REDACTED
2507323,2,4,8,2,4,14,REDACTED
2507650,1,4,7,4,3,14,REDACTED
2507650,2,4,8,11,3,22,REDACTED
2507650,3,4,6,4,2,12,REDACTED
2507693,1,0,0,0,0,0,REDACTED
2507693,2,0,6,3,0,9,REDACTED
2507797,1,12,11,7,0,18,REDACTED
2507797,2,2,2,0,0,2,REDACTED
2507948,1,5,1,0,0,1,REDACTED
2507948,2,5,10,5,5,20,REDACTED
2507948,3,1,0,0,0,0,REDACTED
2507948,4,5,9,9,3,21,REDACTED
2507985,1,3,5,4,0,9,REDACTED
2507985,2,0,0,0,0,0,REDACTED
2508072,1,13,12,0,0,12,REDACTED
2508072,2,0,0,0,0,0,REDACTED
2508072,3,2,3,6,0,9,REDACTED
2508480,1,21,23,20,14,57,REDACTED
2508480,2,5,2,2,8,12,REDACTED
2508480,3,5,9,3,7,19,REDACTED
2509020,1,3,3,0,2,5,REDACTED
2509020,2,5,5,0,6,11,REDACTED
2509020,3,0,0,0,0,0,REDACTED
2509143,1,0,0,0,0,0,REDACTED
2509182,1,4,10,0,0,10,REDACTED
2509182,2,3,4,0,0,4,REDACTED
2509182,3,9,10,0,0,10,REDACTED
2509399,1,0,0,0,0,0,REDACTED
2509399,2,0,0,0,0,0,REDACTED
2509600,1,7,8,2,0,10,REDACTED
2509600,2,0,0,0,0,0,REDACTED
2509600,3,3,3,4,0,7,REDACTED
2510096,1,2,25,23,0,48,REDACTED
2510096,2,10,12,15,0,27,REDACTED
2510096,3,2,0,5,0,5,REDACTED
2510121,1,7,3,16,0,19,REDACTED
2510121,2,5,4,7,0,11,REDACTED
2510550,1,2,4,9,3,16,REDACTED
2510550,2,2,6,8,9,23,REDACTED
2510930,1,3,7,13,4,24,REDACTED
2510930,2,3,2,6,0,8,REDACTED
2510930,3,5,9,11,0,20,REDACTED
2512005,1,3,4,3,3,10,REDACTED
2512005,2,5,5,3,4,12,REDACTED
2512005,3,3,7,11,11,29,REDACTED
2512457,1,7,11,25,12,48,REDACTED
2512532,1,3,3,0,5,8,REDACTED
2512532,2,8,9,16,8,33,REDACTED
2513360,1,5,7,9,4,20,REDACTED
2513360,2,8,8,11,6,25,REDACTED
2514061,1,12,11,11,8,30,REDACTED
2514061,2,6,3,7,2,12,REDACTED
2514061,3,0,0,0,0,0,REDACTED
2514661,1,7,7,6,4,17,REDACTED
2514661,2,4,7,8,4,19,REDACTED
2514915,1,3,3,6,7,16,REDACTED
2514915,2,8,10,7,5,22,REDACTED
2515105,1,8,6,3,10,19,REDACTED
2515105,2,2,5,7,7,19,REDACTED
2515105,3,6,5,1,11,17,REDACTED
2515105,4,0,0,1,6,7,REDACTED
2515209,1,0,0,5,1,6,REDACTED
2515209,2,4,4,5,2,11,REDACTED
2515992,1,4,4,1,2,7,REDACTED
2515992,2,2,2,1,12,15,REDACTED
2515992,3,10,10,16,5,31,REDACTED
2516057,1,2,2,7,0,9,REDACTED
2516057,2,2,0,5,0,5,REDACTED
2516057,3,8,7,0,0,7,REDACTED
2517000,1,13,13,5,4,22,REDACTED
2517379,1,6,9,10,4,23,REDACTED
2517379,2,7,10,5,0,15,REDACTED
2519303,1,5,7,16,0,23,REDACTED
2519303,2,5,8,1,3,12,REDACTED
2519303,3,0,0,0,0,0,REDACTED
2519303,4,0,0,5,0,5,REDACTED
2519306,1,3,4,6,2,12,REDACTED
2519306,2,0,0,0,3,3,REDACTED
2519981,1,5,7,6,7,20,REDACTED
2519981,2,0,0,2,6,8,REDACTED
2520139,3,5,6,3,3,12,REDACTED
2520341,1,9,8,10,8,26,REDACTED
2520341,2,4,4,11,2,17,REDACTED
2520733,1,6,5,0,0,5,REDACTED
2520733,2,9,9,0,0,9,REDACTED
2521451,1,2,4,1,1,6,REDACTED
2521451,2,4,4,2,2,8,REDACTED
2521495,1,3,5,0,2,7,REDACTED
2521495,2,3,7,3,0,10,REDACTED
2521495,3,0,0,0,0,0,REDACTED
2521495,4,2,3,4,3,10,REDACTED
2521765,1,9,15,7,4,26,REDACTED
2521765,2,11,13,4,5,22,REDACTED
2521827,1,6,8,7,8,23,REDACTED
2522094,1,3,2,5,1,8,REDACTED
2522094,2,1,1,12,4,17,REDACTED
2522094,3,1,1,12,2,15,REDACTED
2522938,1,8,12,6,15,33,REDACTED
2522938,2,6,7,3,2,12,REDACTED
2523017,1,6,6,4,4,14,REDACTED
2523017,2,3,3,4,4,11,REDACTED
2523017,3,3,6,3,8,17,REDACTED
2523409,1,6,3,0,0,3,REDACTED
2523409,2,0,0,5,6,11,REDACTED
2523439,1,7,7,6,0,13,REDACTED
2523439,2,2,2,6,0,8,REDACTED
2524174,1,9,10,3,4,17,REDACTED
2524174,2,2,2,2,0,4,REDACTED
2524174,3,0,0,0,4,4,REDACTED
2524719,1,5,7,5,7,19,REDACTED
2524719,2,4,0,2,5,7,REDACTED
2524719,3,3,5,2,2,9,REDACTED
2525092,1,2,1,4,10,15,REDACTED
2525092,2,2,3,5,5,13,REDACTED
2525500,1,4,7,8,6,21,REDACTED
2525500,2,3,6,3,5,14,REDACTED
2525581,1,18,10,9,4,23,REDACTED
2525581,2,6,7,1,5,13,REDACTED
2525758,1,0,0,0,0,0,REDACTED
2525758,2,0,0,0,0,0,REDACTED
2525758,3,0,0,0,0,0,REDACTED
2526184,1,4,11,18,9,38,REDACTED
2526184,2,10,10,4,10,24,REDACTED
2526572,1,11,11,0,0,11,REDACTED
2526572,2,14,15,8,7,30,REDACTED
2526572,3,6,6,3,5,14,REDACTED
2527241,1,7,9,10,3,22,REDACTED
2527241,2,10,14,11,5,30,REDACTED
2527584,1,0,0,5,0,5,REDACTED
2527584,2,7,7,2,0,9,REDACTED
2528356,1,2,0,0,0,0,REDACTED
2528356,2,2,3,3,2,8,REDACTED
2528356,3,2,6,2,1,9,REDACTED
2528542,1,3,0,0,0,0,REDACTED
2528542,2,8,16,12,11,39,REDACTED
2528542,3,8,11,0,0,11,REDACTED
2528830,1,5,6,3,4,13,REDACTED
2528830,2,8,3,0,0,3,REDACTED
2529097,1,0,6,0,4,10,REDACTED
2529211,1,11,14,13,11,38,REDACTED
2529211,2,6,3,6,2,11,REDACTED
2529211,3,4,5,7,3,15,REDACTED
2529345,1,0,0,10,0,10,REDACTED
2529345,2,4,1,0,7,8,REDACTED
2529466,1,7,7,2,6,15,REDACTED
2529466,2,4,5,7,5,17,REDACTED
2529800,1,6,6,3,0,9,REDACTED
2529800,2,10,11,16,12,39,REDACTED
2529928,1,4,2,7,2,11,REDACTED
2529928,2,2,1,3,2,6,REDACTED
2530266,1,6,8,2,9,19,REDACTED
2530266,2,4,2,1,5,8,REDACTED
2530266,3,2,2,4,6,12,REDACTED
2530266,4,9,12,4,5,21,REDACTED
2530424,1,0,0,0,0,0,REDACTED
2530424,2,0,0,0,0,0,REDACTED
2530424,3,0,0,0,0,0,REDACTED
2530706,1,5,5,7,0,12,REDACTED
2530706,2,4,3,5,0,8,REDACTED
2530774,1,4,7,6,0,13,REDACTED
2530774,2,14,17,17,5,39,REDACTED
2530807,1,4,3,2,3,8,REDACTED
2530807,2,2,2,4,5,11,REDACTED
2530914,1,16,5,8,0,13,REDACTED
2530914,2,6,5,3,3,11,REDACTED
2531756,1,4,7,5,0,12,REDACTED
2531756,2,4,11,5,0,16,REDACTED
2531890,1,13,16,15,2,33,REDACTED
2531890,2,6,11,14,0,25,REDACTED
2531890,3,6,12,8,0,20,REDACTED
2532201,1,3,13,2,0,15,REDACTED
2532201,2,2,5,9,0,14,REDACTED
2532468,1,4,7,4,0,11,REDACTED
2532468,2,2,3,2,7,12,REDACTED
2532468,3,4,4,3,1,8,REDACTED
2533347,1,4,8,10,9,27,REDACTED
2533347,2,9,10,7,7,24,REDACTED
2533573,1,3,4,2,5,11,REDACTED
2533573,2,11,14,9,9,32,REDACTED
2533573,3,12,13,0,4,17,REDACTED
2533573,4,11,11,0,2,13,REDACTED
2533733,1,2,6,0,0,6,REDACTED
2533733,2,5,13,0,0,13,REDACTED
2533733,3,2,0,0,0,0,REDACTED
2533951,1,2,2,0,0,2,REDACTED
2533951,2,0,0,0,0,0,REDACTED
2534253,1,3,4,7,6,17,REDACTED
2534253,2,5,5,4,6,15,REDACTED
2534253,3,0,0,0,0,0,REDACTED
2534253,4,5,6,5,2,13,REDACTED
2534862,1,12,9,3,8,20,REDACTED
2534862,2,3,3,0,5,8,REDACTED
2534999,1,8,18,4,13,35,REDACTED
2534999,2,6,14,24,14,52,REDACTED
2535362,1,6,2,14,11,27,REDACTED
2535362,2,6,10,8,5,23,REDACTED
2535482,1,4,4,5,4,13,REDACTED
2535482,2,2,2,1,0,3,REDACTED
2535482,3,0,0,0,4,4,REDACTED
2535840,1,16,11,10,16,37,REDACTED
2535840,2,0,0,9,0,9,REDACTED
2536089,1,5,5,5,12,22,REDACTED
2536089,2,9,2,10,3,15,REDACTED
2536089,3,5,10,6,0,16,REDACTED
2536965,1,7,7,5,17,29,REDACTED
2536965,2,2,1,2,5,8,REDACTED
2537324,1,12,17,13,8,38,REDACTED
2537324,2,12,13,0,8,21,REDACTED
2537613,1,2,2,0,0,2,REDACTED
2537613,2,2,2,0,0,2,REDACTED
2537754,1,14,11,3,1,15,REDACTED
2537754,2,0,0,0,0,0,REDACTED
2538734,1,4,13,0,0,13,REDACTED
2538734,2,4,2,13,9,24,REDACTED
2538734,3,5,7,5,0,12,REDACTED
2538928,1,3,3,0,0,3,REDACTED
2538928,2,0,0,0,0,0,REDACTED
2538928,3,6,3,0,0,3,REDACTED
2539701,1,4,4,1,10,15,REDACTED
2540216,1,6,6,3,0,9,REDACTED
2540216,2,6,2,2,0,4,REDACTED
2540455,1,2,2,2,2,6,REDACTED
2540455,2,0,0,0,0,0,REDACTED
2540455,3,2,0,1,0,1,REDACTED
2540455,4,0,0,0,0,0,REDACTED
2540516,1,6,7,13,9,29,REDACTED
2540516,2,8,9,9,11,29,REDACTED
2540516,5,0,0,8,5,13,REDACTED
2541810,1,5,5,13,8,26,REDACTED
2541810,2,11,10,18,3,31,REDACTED
2541893,1,4,4,0,10,14,REDACTED
2541893,2,9,7,5,1,13,REDACTED
2541893,3,13,0,0,4,4,REDACTED
2541893,4,0,0,0,0,0,REDACTED
2542363,1,2,4,4,9,17,REDACTED
2542363,2,4,7,0,0,7,REDACTED
2542952,1,0,0,0,0,0,REDACTED
2543232,1,3,7,5,7,19,REDACTED
2543232,2,8,8,2,7,17,REDACTED
2543351,1,11,6,5,4,15,REDACTED
2543351,2,7,5,0,2,7,REDACTED
2543686,1,2,2,5,9,16,REDACTED
2543686,2,2,2,3,3,8,REDACTED
2543686,3,5,8,2,2,12,REDACTED
2543761,1,2,2,9,3,14,REDACTED
2544163,1,5,5,7,4,16,REDACTED
2544163,2,4,4,6,5,15,REDACTED
2544267,1,7,10,17,16,43,REDACTED
2544267,2,5,7,11,8,26,REDACTED
2544323,1,13,2,3,8,13,REDACTED
2544323,2,4,3,4,4,11,REDACTED
2544323,3,5,0,5,0,5,REDACTED
2544718,1,8,7,12,3,22,REDACTED
2544718,2,9,7,8,8,23,REDACTED
2545402,1,9,10,10,0,20,REDACTED
2545402,2,7,8,3,5,16,REDACTED
2545657,1,7,6,4,6,16,REDACTED
2546037,1,4,3,9,6,18,REDACTED
2546037,2,4,2,7,0,9,REDACTED
2546037,3,4,4,6,0,10,REDACTED
2546903,1,3,3,3,3,9,REDACTED
2547158,1,0,0,0,0,0,REDACTED
2547175,1,2,3,4,12,19,REDACTED
2547175,2,3,6,3,7,16,REDACTED
2547198,1,4,5,5,0,10,REDACTED
2547198,2,4,2,0,9,11,REDACTED
2547198,3,0,0,0,0,0,REDACTED
2547198,4,3,3,0,1,4,REDACTED
2547341,1,13,8,20,0,28,REDACTED
2547341,2,7,10,6,3,19,REDACTED
2547341,3,3,5,1,0,6,REDACTED
2547399,1,2,2,3,1,6,REDACTED
2547399,2,13,19,10,13,42,REDACTED
2547399,3,2,2,4,7,13,REDACTED
2548142,1,8,9,0,6,15,REDACTED
2548142,2,4,4,0,6,10,REDACTED
2548142,3,5,0,5,3,8,REDACTED
2548700,1,7,7,0,2,9,REDACTED
2548700,2,3,4,4,0,8,REDACTED
2548700,3,4,5,5,15,25,REDACTED
2549119,1,7,10,5,10,25,REDACTED
2549119,2,16,19,6,12,37,REDACTED
2549493,1,2,1,6,2,9,REDACTED
2549493,2,4,3,3,6,12,REDACTED
2549665,1,6,6,3,0,9,REDACTED
2549665,2,7,9,9,1,19,REDACTED
2549665,3,2,3,3,0,6,REDACTED
2549824,1,5,5,11,0,16,REDACTED
2549824,2,3,1,6,0,7,REDACTED
2550653,1,13,13,17,9,39,REDACTED
2550653,2,17,15,11,2,28,REDACTED
2550653,3,5,11,10,11,32,REDACTED
2550653,4,0,0,0,0,0,REDACTED
2551016,1,19,13,22,11,46,REDACTED
2551016,2,2,1,3,6,10,REDACTED
2551016,3,8,9,0,4,13,REDACTED
2551016,4,5,10,6,2,18,REDACTED
2551589,1,3,0,3,2,5,REDACTED
2551589,2,0,0,0,0,0,REDACTED
2551589,3,2,2,8,3,13,REDACTED
2552191,1,1,2,2,2,6,REDACTED
2552191,2,2,2,5,5,12,REDACTED
2552191,3,0,0,0,0,0,REDACTED
2552191,4,2,3,5,5,13,REDACTED
2552298,1,2,2,4,3,9,REDACTED
2552298,2,2,4,8,1,13,REDACTED
2552298,3,0,2,9,4,15,REDACTED
2552421,1,9,10,13,2,25,REDACTED
2552421,2,4,1,7,2,10,REDACTED
2552421,3,4,0,0,0,0,REDACTED
2552907,1,8,7,9,5,21,REDACTED
2552907,2,6,4,6,3,13,REDACTED
2553322,1,11,16,6,7,29,REDACTED
2553322,2,6,2,5,6,13,REDACTED
2553322,3,2,6,4,4,14,REDACTED
2554265,1,5,6,7,0,13,REDACTED
2554566,1,4,5,0,4,9,REDACTED
2554566,2,10,19,0,8,27,REDACTED
2554829,1,0,0,1,20,21,REDACTED
2554829,2,0,1,4,10,15,REDACTED
2554829,3,2,1,0,3,4,REDACTED
2554980,1,4,4,0,0,4,REDACTED
2554980,2,2,2,0,0,2,REDACTED
2555160,1,6,7,5,7,19,REDACTED
2555160,2,0,0,0,0,0,REDACTED
2555160,3,2,12,10,0,22,REDACTED
2555976,1,2,2,4,2,8,REDACTED
2555976,2,7,6,4,5,15,REDACTED
2555976,3,0,0,6,2,8,REDACTED
2556244,1,7,9,3,3,15,REDACTED
2556244,2,6,10,0,4,14,REDACTED
2556356,1,2,8,8,7,23,REDACTED
2556356,2,0,0,0,0,0,REDACTED
2556463,1,5,7,10,15,32,REDACTED
2556463,2,6,6,21,17,44,REDACTED
2556463,3,2,7,5,0,12,REDACTED
2556567,1,7,7,7,15,29,REDACTED
2556567,2,6,6,5,17,28,REDACTED
2556593,1,6,8,10,10,28,REDACTED
2556593,2,9,10,4,3,17,REDACTED
2557353,1,10,3,1,1,5,REDACTED
2557353,2,9,4,2,3,9,REDACTED
2558011,1,8,8,4,7,19,REDACTED
2558011,2,4,2,2,6,10,REDACTED
2558011,3,4,11,3,5,19,REDACTED
2558011,4,2,7,10,11,28,REDACTED
2558156,1,4,4,1,0,5,REDACTED
2558156,2,5,5,4,0,9,REDACTED
2558351,1,4,4,0,0,4,REDACTED
2558351,2,9,10,7,8,25,REDACTED
2558605,1,7,7,8,9,24,REDACTED
2558605,2,6,6,2,8,16,REDACTED
2558605,3,6,10,7,10,27,REDACTED
2558605,4,2,1,0,0,1,REDACTED
2559142,1,4,3,0,4,7,REDACTED
2559142,2,0,1,0,0,1,REDACTED
2559375,1,8,0,2,6,8,REDACTED
2559375,2,5,5,0,2,7,REDACTED
2559375,3,7,7,2,0,9,REDACTED
2559609,1,4,3,2,2,7,REDACTED
2559609,2,3,5,0,4,9,REDACTED
2559682,1,8,7,7,2,16,REDACTED
2559682,2,0,0,6,6,12,REDACTED
2559809,1,2,4,3,4,11,REDACTED
2559809,2,9,8,15,13,36,REDACTED
2559809,3,4,2,2,1,5,REDACTED
2560802,1,6,6,6,0,12,REDACTED
2560802,2,14,18,17,7,42,REDACTED
2561887,1,4,7,4,7,18,REDACTED
2561887,2,8,9,8,0,17,REDACTED
2562127,1,11,9,8,22,39,REDACTED
2562127,2,2,5,5,28,38,REDACTED
2562127,3,4,6,5,16,27,REDACTED
2563198,1,2,2,3,0,5,REDACTED
2563198,2,0,0,0,0,0,REDACTED
2564055,1,4,5,2,0,7,REDACTED
2565278,1,7,9,7,9,25,REDACTED
2565278,2,2,3,2,4,9,REDACTED
2565725,1,9,9,9,7,25,REDACTED
2565725,2,12,15,9,8,32,REDACTED
2566020,1,4,4,4,9,17,REDACTED
2566020,2,8,7,13,10,30,REDACTED
2566671,1,9,7,7,7,21,REDACTED
2566671,2,10,24,5,9,38,REDACTED
2567851,1,0,4,0,0,4,REDACTED
2567851,2,0,0,0,0,0,REDACTED
2568069,1,5,11,13,14,38,REDACTED
2568069,2,0,1,7,4,12,REDACTED
2568570,1,11,11,11,11,33,REDACTED
2568570,2,6,6,10,12,28,REDACTED
2569073,1,7,13,1,2,16,REDACTED
2569073,2,9,12,14,13,39,REDACTED
2569183,1,4,4,3,1,8,REDACTED
2569183,2,2,2,2,1,5,REDACTED
2569945,1,4,12,0,0,12,REDACTED
2569945,2,2,2,0,2,4,REDACTED
2569945,3,0,0,0,0,0,REDACTED
2569945,4,0,0,0,0,0,REDACTED
2570142,1,6,8,13,21,42,REDACTED
2571196,1,14,15,4,2,21,REDACTED
2571196,2,7,6,0,2,8,REDACTED
2571399,1,2,2,2,2,6,REDACTED
2571399,2,4,8,2,11,21,REDACTED
2571556,1,0,3,2,9,14,REDACTED
2571556,2,2,2,0,12,14,REDACTED
2571600,1,2,10,5,0,15,REDACTED
2571600,2,0,2,0,0,2,REDACTED
2571600,3,0,0,0,12,12,REDACTED
2571664,1,6,10,1,4,15,REDACTED
2571664,2,2,2,2,0,4,REDACTED
2571732,1,2,3,3,10,16,REDACTED
2571732,2,2,1,0,13,14,REDACTED
2571929,1,6,11,0,2,13,REDACTED
2572858,1,0,0,0,0,0,REDACTED
2572868,1,8,10,9,13,32,REDACTED
2573618,1,0,0,0,0,0,REDACTED
2573618,2,0,0,0,0,0,REDACTED
2573760,1,8,9,7,7,23,REDACTED
2573760,2,4,3,0,2,5,REDACTED
2574032,1,8,8,3,9,20,REDACTED
2574032,2,6,11,6,0,17,REDACTED
2574032,3,6,0,3,2,5,REDACTED
2574141,1,8,5,0,2,7,REDACTED
2574141,2,6,4,2,0,6,REDACTED
2574433,1,5,5,6,5,16,REDACTED
2575454,1,6,5,6,8,19,REDACTED
2575454,2,5,3,7,8,18,REDACTED
2575454,3,10,11,7,11,29,REDACTED
2575773,1,2,2,0,0,2,REDACTED
2575773,2,4,2,0,0,2,REDACTED
2575773,3,2,0,0,0,0,REDACTED
2575773,4,6,5,0,0,5,REDACTED
2575823,1,3,2,13,9,24,REDACTED
2575823,2,4,6,10,16,32,REDACTED
2575823,3,6,8,7,11,26,REDACTED
2575823,4,2,13,14,12,39,REDACTED
2576001,1,4,17,14,13,44,REDACTED
2576001,2,5,6,0,0,6,REDACTED
2576001,3,2,4,4,9,17,REDACTED
2576343,1,3,4,4,3,11,REDACTED
2576343,2,4,7,11,7,25,REDACTED
2576343,3,0,7,0,5,12,REDACTED
2576343,4,5,6,6,5,17,REDACTED
2576492,1,4,4,0,0,4,REDACTED
2576492,2,3,4,11,2,17,REDACTED
2576492,3,5,9,8,9,26,REDACTED
2577141,1,5,5,4,3,12,REDACTED
2577141,2,7,7,12,7,26,REDACTED
2577141,3,6,5,13,6,24,REDACTED
2577289,1,9,4,0,1,5,REDACTED
2577289,2,7,2,3,3,8,REDACTED
2577289,3,3,3,6,6,15,REDACTED
2577289,4,13,12,1,1,14,REDACTED
2577665,1,4,1,7,2,10,REDACTED
2577665,2,3,6,2,10,18,REDACTED
2578866,1,6,6,10,2,18,REDACTED
2578866,2,8,10,0,4,14,REDACTED
2578866,3,10,10,2,5,17,REDACTED
2578869,1,0,0,4,0,4,REDACTED
2578972,1,6,6,14,6,26,REDACTED
2578972,2,5,3,2,5,10,REDACTED
2578972,3,2,2,5,5,12,REDACTED
2578972,4,2,2,3,2,7,REDACTED
2579401,1,4,9,7,6,22,REDACTED
2579401,2,2,0,0,2,2,REDACTED
2579401,3,2,2,2,5,9,REDACTED
2579792,1,8,15,5,7,27,REDACTED
2579792,2,2,3,3,7,13,REDACTED
2579792,3,2,2,0,2,4,REDACTED
2580205,1,4,3,12,2,17,REDACTED
2580205,2,11,5,11,10,26,REDACTED
2580206,1,8,9,0,0,9,REDACTED
2580858,1,4,3,3,2,8,REDACTED
2580858,2,13,16,9,13,38,REDACTED
2580858,3,0,0,0,0,0,REDACTED
2581349,1,7,7,8,13,28,REDACTED
2581349,2,13,12,10,14,36,REDACTED
2581349,3,4,5,0,0,5,REDACTED
2581349,4,0,3,1,2,6,REDACTED
2581366,1,13,11,0,0,11,REDACTED
2581441,1,2,2,8,0,10,REDACTED
2581441,2,7,7,2,0,9,REDACTED
2581896,1,4,2,0,0,2,REDACTED
2581896,2,7,8,4,10,22,REDACTED
2581896,3,5,6,0,0,6,REDACTED
2582099,1,5,5,3,7,15,REDACTED
2582099,2,13,15,4,5,24,REDACTED
2582199,1,3,4,8,0,12,REDACTED
2582199,2,0,0,0,0,0,REDACTED
2583308,1,6,8,3,7,18,REDACTED
2583308,2,5,3,6,6,15,REDACTED
2583494,1,2,0,0,3,3,REDACTED
2583494,2,7,6,9,9,24,REDACTED
2583494,3,0,0,0,11,11,REDACTED
2583494,4,3,1,2,6,9,REDACTED
2583670,1,8,8,0,0,8,REDACTED
2583897,1,6,1,2,0,3,REDACTED
2584041,1,7,7,4,6,17,REDACTED
2584041,2,6,9,3,5,17,REDACTED
2584602,1,6,8,15,2,25,REDACTED
2584602,2,3,3,2,15,20,REDACTED
2585036,1,2,2,3,4,9,REDACTED
2585036,2,6,1,6,4,11,REDACTED
2585716,1,8,7,17,0,24,REDACTED
2585967,1,0,0,6,11,17,REDACTED
2585967,2,3,3,3,2,8,REDACTED
2585967,3,3,5,0,6,11,REDACTED
2587529,1,8,8,3,4,15,REDACTED
2587529,2,4,2,10,2,14,REDACTED
2588763,1,5,6,4,3,13,REDACTED
2588763,2,6,8,2,0,10,REDACTED
2588763,3,5,12,13,3,28,REDACTED
2588861,1,10,10,8,12,30,REDACTED
2588861,2,10,7,12,21,40,REDACTED
2589731,1,10,10,9,6,25,REDACTED
2589731,2,2,3,3,5,11,REDACTED
2589731,3,3,3,3,2,8,REDACTED
2589873,1,2,3,6,0,9,REDACTED
2589873,2,4,5,6,0,11,REDACTED
2591249,1,6,13,6,6,25,REDACTED
2591249,2,6,8,7,6,21,REDACTED
2591249,3,3,29,17,15,61,REDACTED
2591281,1,6,4,4,6,14,REDACTED
2591511,1,4,4,2,0,6,REDACTED
2591511,2,2,3,2,0,5,REDACTED
2591582,1,8,8,3,0,11,REDACTED
2591582,2,7,7,2,11,20,REDACTED
2591582,3,8,9,6,4,19,REDACTED
2591866,1,7,7,13,7,27,REDACTED
2591866,2,10,9,15,11,35,REDACTED
2592915,1,2,0,0,0,0,REDACTED
2592915,2,4,0,0,0,0,REDACTED
2592915,3,0,0,0,0,0,REDACTED
2592915,4,0,0,0,0,0,REDACTED
2592931,1,5,11,11,10,32,REDACTED
2592931,2,4,4,3,3,10,REDACTED
2592968,1,7,11,7,3,21,REDACTED
2592968,2,3,3,2,0,5,REDACTED
2592968,3,9,9,5,2,16,REDACTED
2593211,1,9,9,6,0,15,REDACTED
2593211,2,9,7,14,9,30,REDACTED
2593211,3,3,4,13,7,24,REDACTED
2593356,1,9,7,0,6,13,REDACTED
2593356,2,6,3,0,4,7,REDACTED
2594174,1,3,4,6,4,14,REDACTED
2594174,2,7,9,1,2,12,REDACTED
2594278,1,7,1,2,0,3,REDACTED
2594278,2,6,4,0,0,4,REDACTED
2594908,1,4,6,9,3,18,REDACTED
2594908,2,2,0,2,6,8,REDACTED
2594908,3,10,6,12,0,18,REDACTED
2595329,1,2,2,12,3,17,REDACTED
2595329,2,2,2,4,0,6,REDACTED
2595329,3,3,8,7,5,20,REDACTED
2596197,1,6,8,11,8,27,REDACTED
2596197,2,5,5,3,6,14,REDACTED
2597327,1,13,20,4,10,34,REDACTED
2597327,2,0,0,0,0,0,REDACTED
2597369,1,2,4,0,8,12,REDACTED
2597369,2,3,9,9,7,25,REDACTED
2598758,1,5,4,2,0,6,REDACTED
2598758,2,3,5,7,4,16,REDACTED
2598758,3,4,0,5,3,8,REDACTED
2598758,4,3,5,13,0,18,REDACTED
2599163,1,8,4,2,5,11,REDACTED
2599163,2,4,3,0,0,3,REDACTED
2599452,1,2,2,4,6,12,REDACTED
2599452,2,5,1,7,3,11,REDACTED
2599587,1,11,11,11,0,22,REDACTED
2599587,2,2,3,2,2,7,REDACTED
2599808,1,7,10,1,0,11,REDACTED
2599808,2,4,2,3,1,6,REDACTED
2599819,2,2,2,2,0,4,REDACTED
2599977,1,5,5,3,0,8,REDACTED
2599977,2,11,2,4,13,19,REDACTED
2601856,1,2,2,2,6,10,REDACTED
2601856,2,4,5,13,0,18,REDACTED
2602122,1,6,8,4,5,17,REDACTED
2602122,2,10,5,0,8,13,REDACTED
2603154,1,13,14,10,19,43,REDACTED
2603154,2,7,6,5,2,13,REDACTED
2603325,1,10,13,5,3,21,REDACTED
2604174,1,10,10,9,13,32,REDACTED
2604174,3,22,21,10,0,31,REDACTED
2604482,1,6,6,6,3,15,REDACTED
2604560,1,6,4,4,0,8,REDACTED
2604640,1,3,3,3,2,8,REDACTED
2604640,2,5,5,7,2,14,REDACTED
2604640,3,8,13,12,16,41,REDACTED
2606291,1,0,0,23,13,36,REDACTED
2606291,2,6,6,11,8,25,REDACTED
2606291,3,6,19,6,7,32,REDACTED
2606426,1,5,4,6,2,12,REDACTED
2606694,1,6,8,5,2,15,REDACTED
2607696,1,9,9,11,1,21,REDACTED
2607779,1,5,5,7,6,18,REDACTED
2607779,2,4,9,3,3,15,REDACTED
2607989,1,9,17,14,38,69,REDACTED
2607989,2,2,4,0,5,9,REDACTED
2608789,1,6,6,6,7,19,REDACTED
2608789,2,6,6,9,7,22,REDACTED
2608793,1,4,4,4,3,11,REDACTED
2608938,1,8,9,3,6,18,REDACTED
2608938,2,6,7,3,2,12,REDACTED
2608938,3,4,4,11,4,19,REDACTED
2609724,1,10,11,16,7,34,REDACTED
2609724,2,2,1,4,5,10,REDACTED
2609724,3,7,4,5,2,11,REDACTED
2609981,1,9,7,7,4,18,REDACTED
2610173,1,4,7,3,4,14,REDACTED
2610173,2,5,4,7,6,17,REDACTED
2610379,1,0,1,1,2,4,REDACTED
2610379,2,2,1,6,0,7,REDACTED
2610379,3,2,4,5,3,12,REDACTED
2612631,1,2,3,6,2,11,REDACTED
2612631,2,4,4,2,11,17,REDACTED
2612802,1,8,8,13,9,30,REDACTED
2612802,2,5,7,5,7,19,REDACTED
2614050,1,6,3,0,0,3,REDACTED
2614050,2,2,9,4,0,13,REDACTED
2614050,3,4,4,0,0,4,REDACTED
2614050,4,4,6,0,0,6,REDACTED
2614657,1,3,6,8,0,14,REDACTED
2614657,2,0,0,0,0,0,REDACTED
2614657,3,2,23,4,0,27,REDACTED
2614657,4,2,0,0,0,0,REDACTED
2616190,2,4,9,2,8,19,REDACTED
2616190,3,2,37,2,0,39,REDACTED
2616207,1,4,4,6,5,15,REDACTED
2616207,2,0,0,0,0,0,REDACTED
2616207,3,5,6,8,10,24,REDACTED
2616554,1,6,3,11,0,14,REDACTED
2616554,2,2,0,0,0,0,REDACTED
2616554,3,8,0,0,0,0,REDACTED
2616554,4,6,0,0,0,0,REDACTED
2616554,5,0,0,0,0,0,REDACTED
2616554,6,0,0,0,0,0,REDACTED
2616554,7,6,0,0,0,0,REDACTED
2616657,1,4,4,6,4,14,REDACTED
2616657,2,5,3,2,4,9,REDACTED
2616657,3,2,4,4,0,8,REDACTED
2616657,4,8,9,12,11,32,REDACTED
2617413,1,5,3,6,2,11,REDACTED
2617413,3,5,6,2,3,11,REDACTED
2617477,1,8,6,0,9,15,REDACTED
2617477,2,0,0,0,7,7,REDACTED
2617505,1,4,4,2,5,11,REDACTED
2617505,2,5,2,4,8,14,REDACTED
2617607,1,5,5,9,5,19,REDACTED
2617607,2,7,7,0,2,9,REDACTED
2617936,1,5,5,4,0,9,REDACTED
2619872,1,5,5,10,9,24,REDACTED
2619872,2,7,8,8,7,23,REDACTED
2619872,3,4,4,6,9,19,REDACTED
2620139,1,3,3,8,8,19,REDACTED
2620139,2,8,15,18,8,41,REDACTED
2620139,3,3,18,13,9,40,REDACTED
2620351,1,11,12,7,10,29,REDACTED
2620351,2,9,13,10,3,26,REDACTED
2620781,1,10,9,8,11,28,REDACTED
2620781,2,7,8,7,4,19,REDACTED
2621378,1,2,3,7,2,12,REDACTED
2621378,2,3,5,7,5,17,REDACTED
2621640,1,9,12,4,11,27,REDACTED
2622558,1,6,10,7,6,23,REDACTED
2622558,2,5,5,5,14,24,REDACTED
2622558,3,4,6,5,0,11,REDACTED
2622558,4,0,0,0,0,0,REDACTED
2623909,1,2,0,4,4,8,REDACTED
2623909,2,2,0,4,4,8,REDACTED
2623909,3,0,0,0,0,0,REDACTED
2623909,4,3,1,2,2,5,REDACTED
2624311,1,8,10,7,6,23,REDACTED
2624311,2,7,14,14,3,31,REDACTED
2625601,1,7,7,10,10,27,REDACTED
2625601,2,7,10,13,11,34,REDACTED
2625922,1,8,9,10,6,25,REDACTED
2626138,1,9,11,15,0,26,REDACTED
2626138,2,8,17,18,6,41,REDACTED
2626506,1,5,5,5,11,21,REDACTED
2626506,2,0,0,4,6,10,REDACTED
2626560,1,5,6,1,12,19,REDACTED
2626560,2,3,6,7,4,17,REDACTED
2626560,3,0,0,0,0,0,REDACTED
2626650,1,2,2,0,6,8,REDACTED
2626650,2,0,0,0,6,6,REDACTED
2626659,1,3,2,0,3,5,REDACTED
2626659,2,0,0,0,0,0,REDACTED
2626994,1,9,7,7,12,26,REDACTED
2626994,2,5,8,3,9,20,REDACTED
2627174,1,6,10,9,1,20,REDACTED
2627174,2,4,4,5,4,13,REDACTED
2627174,3,6,17,1,0,18,REDACTED
2627367,1,0,0,7,6,13,REDACTED
2627367,2,0,0,13,13,26,REDACTED
2627786,1,5,5,1,0,6,REDACTED
2628164,1,7,8,6,0,14,REDACTED
2628164,2,2,2,5,5,12,REDACTED
2628177,1,7,7,7,1,15,REDACTED
2628177,2,8,9,13,9,31,REDACTED
2628313,1,14,10,10,6,26,REDACTED
2628313,2,2,3,4,6,13,REDACTED
2628333,1,7,8,0,8,16,REDACTED
2628333,2,4,3,3,3,9,REDACTED
2629576,1,5,8,3,6,17,REDACTED
2629576,2,5,18,5,9,32,REDACTED
2629672,1,3,3,4,0,7,REDACTED
2629672,2,3,4,2,2,8,REDACTED
2629672,3,2,2,3,0,5,REDACTED
2629672,4,3,4,0,0,4,REDACTED
2630646,1,10,15,9,10,34,REDACTED
2630888,1,6,7,0,0,7,REDACTED
2630888,2,3,4,0,0,4,REDACTED
2630962,1,14,14,5,4,23,REDACTED
2630962,2,5,5,8,9,22,REDACTED
2631727,1,3,3,0,0,3,REDACTED
2634323,1,17,20,19,0,39,REDACTED
2634323,2,4,0,0,0,0,REDACTED
2634323,3,0,0,0,0,0,REDACTED
2634323,4,6,9,0,0,9,REDACTED
2634323,5,7,3,0,0,3,REDACTED
2634796,1,12,13,8,7,28,REDACTED
2634796,2,9,9,6,4,19,REDACTED
2634924,1,5,12,1,0,13,REDACTED
2634924,2,4,21,13,21,55,REDACTED
2634924,3,2,4,8,14,26,REDACTED
2635832,1,8,12,3,11,26,REDACTED
2636221,1,10,8,4,0,12,REDACTED
2636221,2,3,4,9,0,13,REDACTED
2636285,1,5,7,17,9,33,REDACTED
2636285,2,2,2,16,3,21,REDACTED
2636285,3,5,12,7,5,24,REDACTED
2636473,1,8,10,4,6,20,REDACTED
2636473,2,3,6,7,8,21,REDACTED
2637376,1,5,3,8,2,13,REDACTED
2637376,2,2,3,4,0,7,REDACTED
2637476,1,0,0,6,4,10,REDACTED
2637476,2,8,11,9,7,27,REDACTED
2637476,3,3,5,2,13,20,REDACTED
2637826,1,4,5,3,7,15,REDACTED
2637826,2,2,2,7,6,15,REDACTED
2637826,3,0,7,12,2,21,REDACTED
2637869,1,6,6,3,1,10,REDACTED
2637869,2,0,0,2,0,2,REDACTED
2638057,1,4,4,10,3,17,REDACTED
2638068,1,5,3,2,4,9,REDACTED
2638068,2,4,16,5,0,21,REDACTED
2638068,3,3,4,4,10,18,REDACTED
2638068,4,0,0,6,4,10,REDACTED
2638114,1,2,2,10,8,20,REDACTED
2638114,2,9,17,8,7,32,REDACTED
2638520,1,9,7,9,2,18,REDACTED
2638520,2,4,1,8,14,23,REDACTED
2638520,3,2,6,14,0,20,REDACTED
2639115,3,0,0,0,0,0,REDACTED
2639115,4,0,0,0,0,0,REDACTED
2639647,1,10,10,10,5,25,REDACTED
2639647,2,4,4,14,5,23,REDACTED
2639695,1,4,7,11,0,18,REDACTED
2639695,2,0,0,0,0,0,REDACTED
2639695,3,6,11,6,0,17,REDACTED
2640207,1,8,23,21,8,52,REDACTED
2640207,2,10,12,7,0,19,REDACTED
2640207,3,5,7,0,0,7,REDACTED
2640207,4,2,6,12,6,24,REDACTED
2640207,5,5,11,10,2,23,REDACTED
2640344,1,7,7,9,11,27,REDACTED
2640344,2,6,12,11,11,34,REDACTED
2640823,1,2,4,7,10,21,REDACTED
2640823,2,8,8,11,18,37,REDACTED
2640823,3,4,3,3,3,9,REDACTED
2640919,1,6,11,10,3,24,REDACTED
2640919,2,2,4,0,3,7,REDACTED
2640919,3,5,5,0,3,8,REDACTED
2640919,4,2,7,11,3,21,REDACTED
2641546,1,10,6,7,0,13,REDACTED
2641546,2,8,6,3,17,26,REDACTED
2641546,3,2,6,0,0,6,REDACTED
2641979,1,8,8,12,7,27,REDACTED
2641979,2,4,4,5,2,11,REDACTED
2641979,3,0,0,1,4,5,REDACTED
2642544,1,11,16,12,12,40,REDACTED
2642544,2,13,15,17,16,48,REDACTED
2642737,1,6,4,0,8,12,REDACTED
2642737,2,0,0,0,0,0,REDACTED
2642819,1,6,7,8,5,20,REDACTED
2642819,2,3,3,3,0,6,REDACTED
2642819,3,0,0,0,6,6,REDACTED
2643270,1,8,9,0,3,12,REDACTED
2643270,2,3,3,1,3,7,REDACTED
2643270,3,3,3,4,3,10,REDACTED
2644246,1,2,2,0,0,2,REDACTED
2644246,2,7,8,0,0,8,REDACTED
2644691,1,10,12,0,0,12,REDACTED
2644691,2,2,8,4,4,16,REDACTED
2645029,1,5,9,2,9,20,REDACTED
2645029,2,6,5,3,3,11,REDACTED
2645300,1,6,8,19,0,27,REDACTED
2645300,2,2,3,0,0,3,REDACTED
2645403,1,3,4,0,10,14,REDACTED
2645403,2,0,2,3,0,5,REDACTED
2645403,3,0,2,0,7,9,REDACTED
2645463,1,5,7,0,10,17,REDACTED
2646837,1,5,5,10,3,18,REDACTED
2646837,2,6,6,7,12,25,REDACTED
2647193,1,4,6,6,5,17,REDACTED
2647193,2,5,9,11,4,24,REDACTED
2647193,3,3,13,10,0,23,REDACTED
2647193,4,3,5,4,2,11,REDACTED
2647386,1,7,8,6,5,19,REDACTED
2647386,2,12,9,10,15,34,REDACTED
2648938,1,11,11,0,0,11,REDACTED
2648938,2,10,4,0,0,4,REDACTED
2649044,1,2,1,11,0,12,REDACTED
2649381,1,4,2,0,0,2,REDACTED
2649381,2,2,3,0,0,3,REDACTED
2649381,3,4,3,0,0,3,REDACTED
2649388,1,3,4,4,0,8,REDACTED
2649388,2,6,17,4,0,21,REDACTED
2650435,1,8,8,4,12,24,REDACTED
2650596,1,8,9,4,5,18,REDACTED
2650596,2,10,7,1,2,10,REDACTED
2650596,3,6,3,0,0,3,REDACTED
2650712,1,11,16,8,11,35,REDACTED
2650969,1,3,4,5,5,14,REDACTED
2650969,2,7,7,6,4,17,REDACTED
2650969,3,8,8,8,4,20,REDACTED
2651292,1,8,10,0,6,16,REDACTED
2652138,1,3,7,6,3,16,REDACTED
2652138,2,2,2,4,2,8,REDACTED
2652194,1,12,3,7,16,26,REDACTED
2652194,2,0,0,0,0,0,REDACTED
2652194,3,2,0,0,0,0,REDACTED
2652194,4,5,36,31,37,104,REDACTED
2653206,1,10,11,9,8,28,REDACTED
2653206,2,15,13,20,3,36,REDACTED
2653415,1,11,9,2,4,15,REDACTED
2653415,2,6,7,5,5,17,REDACTED
2654296,1,7,15,17,3,35,REDACTED
2654296,2,8,6,7,2,15,REDACTED
2654296,3,4,5,0,1,6,REDACTED
2656544,1,4,3,0,0,3,REDACTED
2656544,2,12,3,0,0,3,REDACTED
2656544,3,4,3,0,0,3,REDACTED
2656544,4,7,1,0,0,1,REDACTED
2657051,1,12,14,8,4,26,REDACTED
2657051,2,5,6,3,6,15,REDACTED
2657190,1,11,11,0,0,11,REDACTED
2657300,1,4,4,7,3,14,REDACTED
2657300,2,15,18,6,7,31,REDACTED
2657510,1,5,6,23,11,40,REDACTED
2657510,2,4,2,6,7,15,REDACTED
2657523,1,2,2,0,0,2,REDACTED
2657523,2,14,13,0,0,13,REDACTED
2658525,1,8,7,9,13,29,REDACTED
2658525,2,18,8,8,8,24,REDACTED
2658531,1,2,6,2,6,14,REDACTED
2658531,2,3,4,3,5,12,REDACTED
2658531,3,2,2,2,2,6,REDACTED
2658696,1,2,10,9,23,42,REDACTED
2659106,1,10,9,6,6,21,REDACTED
2659106,2,4,4,2,3,9,REDACTED
2660174,1,15,8,10,5,23,REDACTED
2660700,1,4,4,7,12,23,REDACTED
2660700,2,2,4,2,4,10,REDACTED
2660700,3,0,0,9,0,9,REDACTED
2660700,4,4,4,8,10,22,REDACTED
2660713,1,4,4,2,5,11,REDACTED
2660713,2,3,4,3,4,11,REDACTED
2661567,1,4,4,7,6,17,REDACTED
2661824,1,5,5,11,0,16,REDACTED
2661824,2,5,4,5,0,9,REDACTED
2662124,1,11,12,9,0,21,REDACTED
2662124,2,6,7,5,2,14,REDACTED
2662538,1,4,3,13,9,25,REDACTED
2662538,2,10,10,11,13,34,REDACTED
2662538,3,5,5,6,5,16,REDACTED
2663173,1,2,4,5,10,19,REDACTED
2663173,2,2,1,5,0,6,REDACTED
2663173,3,4,4,8,10,22,REDACTED
2663173,4,4,2,8,0,10,REDACTED
2663763,1,5,7,8,2,17,REDACTED
2663763,2,6,4,3,1,8,REDACTED
2664190,1,7,5,10,9,24,REDACTED
2664190,2,19,20,12,2,34,REDACTED
2664623,1,3,1,2,8,11,REDACTED
2664623,2,4,5,0,3,8,REDACTED
2666231,1,7,8,7,7,22,REDACTED
2666231,2,5,6,0,4,10,REDACTED
2666432,1,15,7,9,7,23,REDACTED
2666432,2,11,6,3,3,12,REDACTED
2699748,1,2,5,5,4,14,REDACTED
2708912,1,2,2,3,4,9,REDACTED
2832202,1,8,7,2,4,13,REDACTED
2889705,1,6,0,3,0,3,REDACTED
2889705,2,8,3,1,7,11,REDACTED
2889705,4,2,2,9,9,20,REDACTED
2889705,5,2,1,7,7,15,REDACTED
2890124,1,2,2,6,2,10,REDACTED
2890124,2,4,4,6,2,12,REDACTED
2911686,1,8,8,8,12,28,REDACTED
2911944,1,6,6,14,3,23,REDACTED
2911944,2,4,8,17,3,28,REDACTED
2915244,1,7,8,3,0,11,REDACTED
2915244,2,6,8,0,0,8,REDACTED
2951216,1,4,8,0,17,25,REDACTED
2951216,2,3,8,2,0,10,REDACTED
2953222,1,4,3,7,5,15,REDACTED
2953222,2,4,4,4,2,10,REDACTED
2954224,1,7,7,5,6,18,REDACTED
2954224,2,5,5,4,2,11,REDACTED
2971847,1,4,6,3,0,9,REDACTED
2971847,2,5,5,0,2,7,REDACTED
2972359,1,13,14,15,5,34,REDACTED
2972359,2,9,9,11,9,29,REDACTED
2984645,1,5,3,15,5,23,REDACTED
2984645,2,7,8,5,0,13,REDACTED
2984731,1,6,6,6,8,20,REDACTED
2984731,2,2,3,1,2,6,REDACTED
2984852,1,4,5,7,1,13,REDACTED
2984852,2,7,5,3,6,14,REDACTED
2984860,1,9,7,4,0,11,REDACTED
2984860,2,2,3,8,0,11,REDACTED
2984911,1,2,0,6,7,13,REDACTED
2984911,2,0,0,0,10,10,REDACTED
2984911,3,0,0,0,3,3,REDACTED
2984975,1,6,6,2,1,9,REDACTED
2984975,2,3,1,6,7,14,REDACTED
2984979,1,3,3,0,0,3,REDACTED
2985075,1,5,4,0,0,4,REDACTED
2985075,2,3,7,0,6,13,REDACTED
2985090,1,10,8,8,8,24,REDACTED
2985090,2,2,6,7,4,17,REDACTED
2985161,1,8,8,6,14,28,REDACTED
2985161,2,8,11,5,13,29,REDACTED
2985161,3,4,4,5,6,15,REDACTED
2985213,1,3,4,2,12,18,REDACTED
2985213,2,8,13,8,3,24,REDACTED
2985225,1,4,5,0,0,5,REDACTED
2985258,1,2,2,2,1,5,REDACTED
2985258,2,3,3,2,0,5,REDACTED
2985298,1,2,3,4,5,12,REDACTED
2985327,1,7,12,17,6,35,REDACTED
2985327,4,4,2,0,0,2,REDACTED
2985336,1,2,3,4,6,13,REDACTED
2985336,2,8,12,8,12,32,REDACTED
2985336,3,0,0,0,0,0,REDACTED
2985361,1,5,5,2,2,9,REDACTED
2985361,2,5,6,15,0,21,REDACTED
2985507,1,4,4,9,3,16,REDACTED
2985507,2,4,5,2,7,14,REDACTED
2985518,1,5,2,2,3,7,REDACTED
2985518,2,14,15,15,14,44,REDACTED
2985585,1,3,3,7,7,17,REDACTED
2985585,2,10,7,15,4,26,REDACTED
2985593,1,5,3,5,5,13,REDACTED
2985643,1,5,5,11,12,28,REDACTED
2985643,2,7,5,12,14,31,REDACTED
2985643,3,5,5,16,3,24,REDACTED
2985773,1,9,7,12,5,24,REDACTED
2985773,2,5,2,8,5,15,REDACTED
2985773,3,5,15,12,4,31,REDACTED
2985773,4,4,0,7,5,12,REDACTED
2985777,1,6,0,4,0,4,REDACTED
2985777,2,0,4,13,3,20,REDACTED
2985777,3,9,9,6,2,17,REDACTED
2985777,4,11,3,0,0,3,REDACTED
2985780,1,8,9,3,8,20,REDACTED
2985780,2,5,4,8,1,13,REDACTED
2985802,1,4,7,8,3,18,REDACTED
2985918,1,2,3,4,4,11,REDACTED
2985918,2,5,5,2,2,9,REDACTED
2985918,3,4,5,5,6,16,REDACTED
2986128,1,9,4,3,0,7,REDACTED
2986128,2,7,5,3,7,15,REDACTED
2986256,1,9,8,3,2,13,REDACTED
2986280,1,4,4,6,8,18,REDACTED
2986280,2,5,3,9,4,16,REDACTED
2986296,1,4,4,8,4,16,REDACTED
2986296,3,0,0,7,6,13,REDACTED
2986363,1,5,5,2,5,12,REDACTED
2986495,1,12,12,6,0,18,REDACTED
2986495,2,4,3,3,0,6,REDACTED
2986536,1,2,2,6,2,10,REDACTED
2986536,2,0,0,0,5,5,REDACTED
2986536,3,2,3,7,3,13,REDACTED
2986613,1,4,2,6,6,14,REDACTED
2986613,2,0,1,4,2,7,REDACTED
2986613,3,3,2,0,3,5,REDACTED
2986613,4,0,0,0,0,0,REDACTED
2986613,5,2,3,5,3,11,REDACTED
2986613,6,0,7,12,9,28,REDACTED
2986624,1,6,7,3,4,14,REDACTED
2986624,2,4,4,1,1,6,REDACTED
2986659,1,6,8,7,0,15,REDACTED
2986862,1,4,6,7,2,15,REDACTED
2986862,2,4,1,15,1,17,REDACTED
2986862,3,4,1,9,0,10,REDACTED
2986946,1,8,9,3,16,28,REDACTED
2986946,2,4,5,3,0,8,REDACTED
2986946,3,2,4,7,0,11,REDACTED
2986961,1,4,2,6,3,11,REDACTED
2987031,1,10,7,7,1,15,REDACTED
2987031,2,3,3,0,7,10,REDACTED
2987031,3,4,9,7,4,20,REDACTED
2987286,1,9,11,4,2,17,REDACTED
2987286,2,2,3,2,17,22,REDACTED
2987302,1,5,3,7,0,10,REDACTED
2987302,2,2,6,3,3,12,REDACTED
2987370,1,5,5,6,15,26,REDACTED
2987375,1,8,13,11,11,35,REDACTED
2987375,2,4,7,11,9,27,REDACTED
2987513,1,0,0,0,0,0,REDACTED
2987513,2,2,2,5,0,7,REDACTED
2987513,3,0,0,0,0,0,REDACTED
2987548,1,5,23,4,5,32,REDACTED
2987548,2,4,4,8,4,16,REDACTED
2987548,3,5,12,14,5,31,REDACTED
2987571,1,7,7,9,9,25,REDACTED
2987571,2,7,6,4,0,10,REDACTED
2987699,1,0,0,0,0,0,REDACTED
2987699,2,4,5,0,0,5,REDACTED
2987702,1,8,10,2,11,23,REDACTED
2987702,2,11,12,6,5,23,REDACTED
2987795,1,5,7,4,0,11,REDACTED
2987811,1,4,6,10,0,16,REDACTED
2987903,1,4,2,0,3,5,REDACTED
2987903,2,13,0,0,5,5,REDACTED
2987903,3,4,4,0,0,4,REDACTED
2987911,1,8,8,9,6,23,REDACTED
2987930,1,3,3,3,3,9,REDACTED
2987985,1,3,6,6,0,12,REDACTED
2988008,1,6,3,3,0,6,REDACTED
2988008,2,2,0,0,0,0,REDACTED
2988008,3,0,0,0,0,0,REDACTED
2988009,1,7,9,0,6,15,REDACTED
2988009,2,2,2,1,3,6,REDACTED
2988009,3,2,0,0,2,2,REDACTED
2988037,1,8,5,0,0,5,REDACTED
2988063,1,3,4,1,0,5,REDACTED
2988063,2,12,3,6,4,13,REDACTED
2988098,1,0,0,13,10,23,REDACTED
2988098,2,4,4,5,8,17,REDACTED
2988171,1,5,8,6,6,20,REDACTED
2988186,1,2,2,2,3,7,REDACTED
2988186,2,3,2,3,3,8,REDACTED
2988186,3,7,6,4,4,14,REDACTED
2988264,1,3,3,10,13,26,REDACTED
2988297,1,0,0,4,2,6,REDACTED
2988297,2,6,5,12,2,19,REDACTED
2988314,1,5,5,5,2,12,REDACTED
2988314,2,5,15,8,2,25,REDACTED
2988347,1,13,12,0,0,12,REDACTED
2988347,2,9,2,0,0,2,REDACTED
2988347,3,7,7,0,0,7,REDACTED
2988347,4,4,0,0,0,0,REDACTED
2988353,1,2,0,0,0,0,REDACTED
2988353,2,0,0,0,2,2,REDACTED
2988353,3,2,0,1,0,1,REDACTED
2988353,5,0,0,0,0,0,REDACTED
2988394,1,2,1,2,2,5,REDACTED
2988394,2,4,3,10,9,22,REDACTED
2988489,1,10,5,5,3,13,REDACTED
2988489,2,12,8,12,5,25,REDACTED
2988549,1,12,13,14,3,30,REDACTED
2988549,2,14,14,5,9,28,REDACTED
2988554,1,0,0,0,0,0,REDACTED
2988554,2,7,7,7,9,23,REDACTED
2988565,1,9,9,8,12,29,REDACTED
2988565,2,11,9,7,5,21,REDACTED
2988651,1,12,15,11,7,33,REDACTED
2988651,2,2,3,4,5,12,REDACTED
2988666,1,12,14,22,17,53,REDACTED
2988666,2,3,1,9,4,14,REDACTED
2988666,3,4,7,9,11,27,REDACTED
2988740,1,8,2,7,14,23,REDACTED
2988895,1,5,5,0,0,5,REDACTED
2988895,2,2,2,0,0,2,REDACTED
2988978,1,0,0,1,0,1,REDACTED
2989048,1,3,4,0,0,4,REDACTED
2989048,2,0,0,0,0,0,REDACTED
2989048,3,0,0,0,0,0,REDACTED
2989048,4,0,0,0,0,0,REDACTED
2989213,1,8,9,7,7,23,REDACTED
2989213,2,2,3,3,6,12,REDACTED
2989285,1,6,6,9,6,21,REDACTED
2989285,2,11,12,8,3,23,REDACTED
2989290,1,0,0,0,0,0,REDACTED
2989290,2,2,1,0,1,2,REDACTED
2989382,1,4,4,3,0,7,REDACTED
2989553,1,5,5,0,0,5,REDACTED
2989553,2,5,5,8,4,17,REDACTED
2989564,1,5,5,4,1,10,REDACTED
2989564,2,3,2,0,12,14,REDACTED
2989679,1,1,5,6,0,11,REDACTED
2989679,2,3,3,0,3,6,REDACTED
2989723,1,6,7,17,12,36,REDACTED
2989723,2,7,4,6,3,13,REDACTED
2989831,1,0,0,12,0,12,REDACTED
2989831,2,0,0,3,1,4,REDACTED
2989897,1,0,0,0,0,0,REDACTED
2990004,1,10,11,12,4,27,REDACTED
2990004,2,6,7,3,11,21,REDACTED
2990004,3,0,0,4,5,9,REDACTED
2990171,1,2,2,5,2,9,REDACTED
2990171,2,12,10,0,0,10,REDACTED
2990314,1,0,0,0,0,0,REDACTED
2990314,2,0,9,0,0,9,REDACTED
2990369,1,2,2,2,1,5,REDACTED
2990369,2,4,2,2,2,6,REDACTED
2990457,1,11,3,0,0,3,REDACTED
2990457,2,3,0,0,0,0,REDACTED
2990457,3,3,11,0,0,11,REDACTED
2990467,1,4,5,4,9,18,REDACTED
2990467,2,4,7,6,2,15,REDACTED
2990644,1,2,2,3,0,5,REDACTED
2990644,2,2,2,3,0,5,REDACTED
2990840,1,7,8,0,0,8,REDACTED
2990869,1,7,7,6,13,26,REDACTED
2990869,2,2,2,3,7,12,REDACTED
2991003,1,6,7,4,9,20,REDACTED
2991013,1,5,5,5,3,13,REDACTED
2991059,1,5,15,11,18,44,REDACTED
2991283,1,8,7,9,7,23,REDACTED
2991364,1,0,0,3,0,3,REDACTED
2991364,2,4,5,2,8,15,REDACTED
2991364,3,2,3,2,4,9,REDACTED
2991364,6,8,7,6,9,22,REDACTED
2991427,1,2,5,4,0,9,REDACTED
2991427,2,2,1,2,3,6,REDACTED
2991455,1,0,0,6,0,6,REDACTED
2991455,2,0,0,6,0,6,REDACTED
2991681,1,2,2,4,2,8,REDACTED
2991681,2,7,7,3,2,12,REDACTED
2991817,1,2,1,5,2,8,REDACTED
2991817,2,0,0,0,1,1,REDACTED
2991855,1,7,12,0,5,17,REDACTED
2991855,2,6,7,0,5,12,REDACTED
2991861,1,7,4,8,4,16,REDACTED
2991915,1,8,10,7,12,29,REDACTED
2991958,1,0,0,4,0,4,REDACTED
2991958,2,0,0,7,0,7,REDACTED
2991959,1,9,13,10,13,36,REDACTED
2991998,1,0,0,12,3,15,REDACTED
2992059,1,3,1,0,0,1,REDACTED
2992059,2,4,8,0,0,8,REDACTED
2992269,1,15,13,7,6,26,REDACTED
2992269,2,8,7,2,4,13,REDACTED
2992269,3,2,0,0,0,0,REDACTED
2992269,4,4,2,2,9,13,REDACTED
2992269,5,5,5,0,0,5,REDACTED
2992274,1,0,0,3,3,6,REDACTED
2992483,1,2,4,3,9,16,REDACTED
2992483,2,2,3,3,9,15,REDACTED
2992483,3,2,5,4,0,9,REDACTED
2992781,1,4,4,9,0,13,REDACTED
2992781,2,2,2,1,0,3,REDACTED
2992852,1,5,6,7,3,16,REDACTED
2992852,2,5,5,6,5,16,REDACTED
2992852,3,2,2,3,3,8,REDACTED
2992864,1,2,4,3,5,12,REDACTED
2992864,2,2,4,0,0,4,REDACTED
2992864,3,4,6,1,0,7,REDACTED
2992944,1,8,8,5,2,15,REDACTED
2992944,2,0,0,10,0,10,REDACTED
2992944,3,3,1,0,3,4,REDACTED
2993048,1,4,6,6,3,15,REDACTED
2993048,2,12,18,0,1,19,REDACTED
2993048,3,4,7,0,8,15,REDACTED
2993096,1,2,2,6,3,11,REDACTED
2993096,2,4,2,3,2,7,REDACTED
2993126,1,2,2,8,4,14,REDACTED
2993126,2,5,5,2,4,11,REDACTED
2993143,1,0,0,0,0,0,REDACTED
2993224,1,5,2,7,4,13,REDACTED
2993304,1,0,0,0,0,0,REDACTED
2993304,2,6,4,3,7,14,REDACTED
2993480,1,10,9,11,5,25,REDACTED
2993480,2,2,4,4,3,11,REDACTED
2993528,1,7,6,2,0,8,REDACTED
2993528,2,12,12,16,9,37,REDACTED
2993528,3,5,5,1,0,6,REDACTED
2993528,4,7,6,7,3,16,REDACTED
2993528,5,5,3,8,2,13,REDACTED
2993556,1,0,0,5,3,8,REDACTED
2993597,1,12,11,7,4,22,REDACTED
2993597,2,10,11,10,0,21,REDACTED
2993718,1,0,0,0,0,0,REDACTED
2993718,2,0,0,0,0,0,REDACTED
2993718,3,0,0,0,0,0,REDACTED
2993856,1,5,5,9,2,16,REDACTED
2993856,2,8,9,0,0,9,REDACTED
2993856,3,0,0,0,0,0,REDACTED
2993918,1,2,1,14,0,15,REDACTED
2993918,2,0,0,0,4,4,REDACTED
2993918,3,10,11,5,0,16,REDACTED
2993998,1,0,0,17,0,17,REDACTED
2993998,2,0,0,9,0,9,REDACTED
2993998,3,0,0,13,0,13,REDACTED
2993998,4,0,0,6,3,9,REDACTED
2993998,5,0,0,7,0,7,REDACTED
2993998,6,0,0,7,3,10,REDACTED
2994371,1,8,3,6,2,11,REDACTED
2994371,2,2,5,10,8,23,REDACTED
2994381,1,2,3,0,0,3,REDACTED
2994381,2,2,5,0,0,5,REDACTED
2994385,1,4,2,3,3,8,REDACTED
2994385,2,2,2,0,0,2,REDACTED
2994399,1,3,4,0,0,4,REDACTED
2994399,2,0,0,0,0,0,REDACTED
2994447,1,10,10,9,12,31,REDACTED
2994447,2,5,5,2,6,13,REDACTED
2994463,1,5,4,0,0,4,REDACTED
2994463,2,2,5,0,0,5,REDACTED
2994463,3,5,5,0,0,5,REDACTED
2994482,1,7,6,2,4,12,REDACTED
2994572,1,10,14,8,1,23,REDACTED
2994803,2,6,6,3,3,12,REDACTED
2994822,1,5,2,3,3,8,REDACTED
2994822,2,5,7,4,0,11,REDACTED
2994895,1,5,6,0,14,20,REDACTED
2994895,2,4,1,0,0,1,REDACTED
2994942,1,2,7,13,6,26,REDACTED
2994942,2,2,0,0,0,0,REDACTED
2994942,3,3,2,0,0,2,REDACTED
2994972,1,13,5,7,8,20,REDACTED
2994972,2,6,6,4,5,15,REDACTED
2995019,1,4,2,1,1,4,REDACTED
2995019,2,0,0,0,0,0,REDACTED
2995050,1,8,6,0,0,6,REDACTED
2995050,2,6,5,6,3,14,REDACTED
2995050,3,8,9,10,9,28,REDACTED
2995058,1,7,5,3,0,8,REDACTED
2995058,2,6,3,0,5,8,REDACTED
2995094,1,2,4,2,0,6,REDACTED
2995094,2,4,7,2,0,9,REDACTED
2995094,3,4,5,32,18,55,REDACTED
2995094,4,1,0,3,4,7,REDACTED
2995107,1,2,3,2,8,13,REDACTED
2995137,1,3,1,0,0,1,REDACTED
2995137,2,4,9,10,0,19,REDACTED
2995184,1,2,1,6,4,11,REDACTED
2995390,1,0,0,4,0,4,REDACTED
2995390,2,3,6,4,0,10,REDACTED
2995404,1,0,0,4,6,10,REDACTED
2995404,2,2,7,4,9,20,REDACTED
2995404,3,1,1,0,6,7,REDACTED
2995438,1,8,10,3,4,17,REDACTED
2995438,2,3,5,6,3,14,REDACTED
2995451,1,9,9,4,7,20,REDACTED
2995451,2,0,0,1,8,9,REDACTED
2995479,1,8,5,3,3,11,REDACTED
2995479,2,5,5,14,11,30,REDACTED
2995479,3,6,9,5,8,22,REDACTED
2995508,1,4,4,2,3,9,REDACTED
2995508,3,7,3,10,1,14,REDACTED
2995508,4,0,2,8,9,19,REDACTED
2995508,5,4,8,7,16,31,REDACTED
2995514,1,4,4,4,3,11,REDACTED
2995514,2,4,4,12,6,22,REDACTED
2995544,1,0,0,4,5,9,REDACTED
2995544,2,0,0,3,8,11,REDACTED
2995584,1,2,1,6,7,14,REDACTED
2995584,2,4,14,11,14,39,REDACTED
2995681,1,5,5,6,10,21,REDACTED
2995681,2,2,2,3,8,13,REDACTED
2995681,3,2,3,2,3,8,REDACTED
2995744,1,3,4,0,7,11,REDACTED
2995744,2,3,7,5,2,14,REDACTED
2995744,3,0,0,0,0,0,REDACTED
2995757,1,0,0,11,0,11,REDACTED
2995757,2,0,0,0,0,0,REDACTED
2995761,1,2,3,6,0,9,REDACTED
2995761,2,2,3,6,0,9,REDACTED
2995761,3,0,0,0,0,0,REDACTED
2995771,1,8,8,2,9,19,REDACTED
2995771,2,12,1,2,0,3,REDACTED
2995771,3,4,5,1,0,6,REDACTED
2995771,4,3,0,9,0,9,REDACTED
2995771,5,2,16,2,0,18,REDACTED
2995771,6,2,3,2,0,5,REDACTED
2995835,1,9,1,3,12,16,REDACTED
2995835,2,6,2,11,5,18,REDACTED
2995843,1,0,0,2,5,7,REDACTED
2995843,2,3,4,7,2,13,REDACTED
2995843,3,0,0,0,0,0,REDACTED
2995843,4,2,3,8,3,14,REDACTED
2995859,1,10,4,5,18,27,REDACTED
2995859,2,2,3,7,6,16,REDACTED
2995859,3,6,6,15,5,26,REDACTED
2996009,1,2,2,2,0,4,REDACTED
2996009,2,6,6,4,2,12,REDACTED
2996061,1,3,3,7,6,16,REDACTED
2996185,1,5,2,5,13,20,REDACTED
2996185,2,9,7,5,4,16,REDACTED
2996193,1,4,2,3,4,9,REDACTED
2996193,2,8,8,5,4,17,REDACTED
2996336,1,10,26,10,0,36,REDACTED
2996336,2,12,14,5,4,23,REDACTED
2996572,1,9,9,4,7,20,REDACTED
2996572,2,0,0,0,0,0,REDACTED
2996572,3,0,0,0,0,0,REDACTED
2996964,1,0,0,0,0,0,REDACTED
2997146,1,14,15,3,4,22,REDACTED
2997146,2,8,7,8,2,17,REDACTED
2997147,1,2,2,9,1,12,REDACTED
2997369,1,8,9,3,0,12,REDACTED
2997369,2,6,6,5,0,11,REDACTED
2997515,2,3,4,7,4,15,REDACTED
2997736,1,12,18,9,6,33,REDACTED
2997736,2,13,20,5,4,29,REDACTED
2997736,3,18,21,20,27,68,REDACTED
2997804,1,14,19,13,3,35,REDACTED
2997804,2,1,2,2,0,4,REDACTED
2997876,1,6,6,1,11,18,REDACTED
2998011,1,3,2,0,3,5,REDACTED
2998011,2,0,0,0,3,3,REDACTED
2998011,3,1,1,3,0,4,REDACTED
2998015,1,4,3,0,0,3,REDACTED
2998015,2,7,5,0,0,5,REDACTED
2998054,1,4,6,5,8,19,REDACTED
2998054,2,2,2,4,12,18,REDACTED
2998139,1,2,4,5,3,12,REDACTED
2998139,2,2,0,0,0,0,REDACTED
2998139,3,0,0,0,0,0,REDACTED
2998139,4,3,0,2,4,6,REDACTED
2998240,1,6,7,7,12,26,REDACTED
2998371,1,6,7,3,4,14,REDACTED
2998371,2,4,5,6,4,15,REDACTED
2998521,1,7,5,4,12,21,REDACTED
2998521,2,6,7,1,0,8,REDACTED
2998601,2,2,2,0,0,2,REDACTED
2998641,1,5,1,17,0,18,REDACTED
2998641,2,2,0,0,0,0,REDACTED
2998641,3,2,2,0,0,2,REDACTED
2998652,1,2,4,3,3,10,REDACTED
2998652,2,2,4,4,4,12,REDACTED
2998652,3,2,1,1,0,2,REDACTED
2998652,4,4,4,12,4,20,REDACTED
2998664,1,6,5,5,6,16,REDACTED
2998664,2,0,0,3,4,7,REDACTED
2998762,1,4,3,5,0,8,REDACTED
2998868,1,6,6,6,3,15,REDACTED
2998868,2,6,6,0,9,15,REDACTED
2998880,1,10,14,7,12,33,REDACTED
2998880,4,4,5,10,11,26,REDACTED
2998946,1,7,3,1,0,4,REDACTED
2998946,2,3,3,10,0,13,REDACTED
2998972,1,9,13,18,7,38,REDACTED
2998981,1,11,12,10,13,35,REDACTED
2998981,3,6,5,7,3,15,REDACTED
2999037,1,10,10,9,7,26,REDACTED
2999037,2,4,5,4,6,15,REDACTED
2999037,3,5,5,3,3,11,REDACTED
2999144,1,4,1,0,3,4,REDACTED
2999184,1,7,8,0,0,8,REDACTED
2999184,2,8,6,2,0,8,REDACTED
2999195,1,15,22,8,7,37,REDACTED
2999232,1,2,2,0,4,6,REDACTED
2999232,2,4,5,10,10,25,REDACTED
2999232,3,6,5,0,1,6,REDACTED
2999232,4,5,4,5,1,10,REDACTED
2999259,1,6,6,7,3,16,REDACTED
2999259,2,4,6,0,5,11,REDACTED
2999270,1,6,8,0,3,11,REDACTED
2999270,2,11,12,9,6,27,REDACTED
2999270,3,12,17,14,2,33,REDACTED
2999270,4,7,17,0,6,23,REDACTED
2999270,5,0,0,0,0,0,REDACTED
2999270,6,0,0,0,0,0,REDACTED
2999409,1,2,2,11,11,24,REDACTED
2999409,2,6,1,6,5,12,REDACTED
2999452,1,10,4,10,11,25,REDACTED
2999452,2,0,0,2,4,6,REDACTED
2999502,1,7,8,8,3,19,REDACTED
2999502,2,3,6,3,3,12,REDACTED
2999549,1,5,6,11,2,19,REDACTED
2999587,1,7,7,5,2,14,REDACTED
2999734,1,2,8,3,5,16,REDACTED
2999734,2,5,5,6,4,15,REDACTED
2999752,1,2,2,2,2,6,REDACTED
2999752,2,9,9,0,12,21,REDACTED
3000261,1,0,0,0,0,0,REDACTED
3000261,2,2,7,0,0,7,REDACTED
3000261,3,9,7,0,0,7,REDACTED
3000261,4,5,0,0,0,0,REDACTED
3000307,1,6,5,9,0,14,REDACTED
3000307,3,0,0,3,0,3,REDACTED
3000307,4,2,1,5,9,15,REDACTED
3000454,1,0,0,0,0,0,REDACTED
3000454,2,0,20,17,0,37,REDACTED
3000454,3,2,4,0,0,4,REDACTED
3000555,1,11,7,1,12,20,REDACTED
3000555,2,3,0,1,0,1,REDACTED
3000555,3,4,5,2,1,8,REDACTED
3000555,4,5,5,0,0,5,REDACTED
3000560,1,4,1,10,0,11,REDACTED
3000579,1,17,16,3,4,23,REDACTED
3000579,2,10,6,0,2,8,REDACTED
3000718,1,6,7,9,0,16,REDACTED
3000735,1,7,8,0,0,8,REDACTED
3000735,2,0,0,0,0,0,REDACTED
3000735,3,0,0,0,0,0,REDACTED
3000786,1,7,3,0,0,3,REDACTED
3000786,2,8,5,4,0,9,REDACTED
3000867,1,4,17,0,0,17,REDACTED
3000883,1,4,4,3,3,10,REDACTED
3000883,2,8,8,4,4,16,REDACTED
3000906,1,2,12,13,6,31,REDACTED
3000906,2,4,4,7,8,19,REDACTED
3000906,3,4,4,2,0,6,REDACTED
3001204,1,4,10,5,4,19,REDACTED
3001204,2,2,9,6,4,19,REDACTED
3001204,3,2,9,9,4,22,REDACTED
3001204,4,2,5,0,0,5,REDACTED
3001246,1,2,2,3,3,8,REDACTED
3001443,1,7,7,2,3,12,REDACTED
3001443,2,4,4,4,2,10,REDACTED
3001463,1,8,9,0,0,9,REDACTED
3001463,2,0,0,0,0,0,REDACTED
3001544,1,4,5,2,0,7,REDACTED
3001544,2,7,11,10,12,33,REDACTED
3001643,1,12,19,7,2,28,REDACTED
3001643,2,16,22,7,21,50,REDACTED
3001675,1,4,1,3,2,6,REDACTED
3001675,2,6,6,11,3,20,REDACTED
3001700,1,4,3,5,5,13,REDACTED
3001700,2,2,5,1,5,11,REDACTED
3001700,3,4,11,7,7,25,REDACTED
3001959,1,2,3,0,4,7,REDACTED
3001970,1,6,10,2,6,18,REDACTED
3001970,2,5,15,14,21,50,REDACTED
3001970,3,4,16,8,11,35,REDACTED
3002052,1,4,3,6,3,12,REDACTED
3002052,2,2,2,2,4,8,REDACTED
3002168,1,13,12,10,8,30,REDACTED
3002168,2,5,5,6,5,16,REDACTED
3002168,3,4,1,9,4,14,REDACTED
3002206,1,7,6,1,1,8,REDACTED
3002206,2,7,7,1,1,9,REDACTED
3002208,1,6,6,6,22,34,REDACTED
3002208,2,7,4,6,3,13,REDACTED
3002279,1,2,2,2,5,9,REDACTED
3002279,2,2,2,7,3,12,REDACTED
3002324,1,1,4,2,4,10,REDACTED
3002324,2,11,16,16,13,45,REDACTED
3002324,3,0,0,0,0,0,REDACTED
3002324,4,2,3,2,2,7,REDACTED
3002324,5,3,4,3,2,9,REDACTED
3002354,1,5,5,5,2,12,REDACTED
3002354,2,7,7,17,0,24,REDACTED
3002354,3,3,6,4,0,10,REDACTED
3002392,1,8,11,7,1,19,REDACTED
3002392,2,5,8,6,12,26,REDACTED
3002524,1,2,5,0,3,8,REDACTED
3002563,1,6,4,5,2,11,REDACTED
3002563,2,6,1,11,0,12,REDACTED
3002568,1,7,3,1,0,4,REDACTED
3002568,2,7,7,7,2,16,REDACTED
3002606,1,7,10,4,0,14,REDACTED
3002606,2,3,3,4,4,11,REDACTED
3002606,3,0,0,0,3,3,REDACTED
3002882,1,4,4,0,0,4,REDACTED
3002882,2,3,4,0,0,4,REDACTED
3003023,1,0,0,4,4,8,REDACTED
3003023,2,9,9,2,1,12,REDACTED
3003184,1,6,6,5,8,19,REDACTED
3003184,2,2,2,3,2,7,REDACTED
3003253,1,8,8,2,8,18,REDACTED
3003253,2,7,7,7,2,16,REDACTED
3003298,1,8,7,4,5,16,REDACTED
3003298,2,4,13,14,10,37,REDACTED
3003540,1,18,20,10,8,38,REDACTED
3003600,1,8,9,3,5,17,REDACTED
3003690,2,12,14,0,0,14,REDACTED
3003788,1,4,7,14,14,35,REDACTED
3003788,2,2,3,3,3,9,REDACTED
3003788,3,2,5,6,0,11,REDACTED
3004056,2,2,6,4,5,15,REDACTED
3004056,3,2,6,5,0,11,REDACTED
3004191,1,5,1,0,0,1,REDACTED
3004191,2,4,4,1,5,10,REDACTED
3004237,1,8,25,4,1,30,REDACTED
3004237,2,7,7,6,0,13,REDACTED
3004485,1,0,1,8,1,10,REDACTED
3004485,2,0,0,8,0,8,REDACTED
3004527,1,4,7,3,0,10,REDACTED
3004527,2,10,12,6,1,19,REDACTED
3004661,1,4,4,0,1,5,REDACTED
3004661,2,5,5,5,0,10,REDACTED
3004828,1,0,0,0,0,0,REDACTED
3004828,2,0,0,0,0,0,REDACTED
3004835,1,9,9,5,6,20,REDACTED
3004847,1,7,6,5,11,22,REDACTED
3004847,2,4,7,4,4,15,REDACTED
3004858,1,0,0,0,5,5,REDACTED
3004858,2,0,0,0,3,3,REDACTED
3004941,1,6,8,7,0,15,REDACTED
3004941,2,11,10,3,0,13,REDACTED
3004980,1,4,11,10,0,21,REDACTED
3004980,2,4,8,0,0,8,REDACTED
3004980,3,0,0,2,2,4,REDACTED
3005089,1,3,3,13,8,24,REDACTED
3005089,2,4,3,0,5,8,REDACTED
3005113,1,9,9,7,4,20,REDACTED
3005134,1,6,5,6,0,11,REDACTED
3005134,2,5,3,0,0,3,REDACTED
3005212,1,6,7,4,10,21,REDACTED
3005212,2,2,2,1,2,5,REDACTED
3005251,1,16,24,22,16,62,REDACTED
3005376,1,2,2,0,3,5,REDACTED
3005376,2,3,11,4,0,15,REDACTED
3005376,3,2,2,0,0,2,REDACTED
3005389,1,2,5,4,3,12,REDACTED
3005389,2,5,5,4,3,12,REDACTED
3005391,1,8,10,10,11,31,REDACTED
3005391,2,8,3,3,4,10,REDACTED
3005391,3,2,5,7,9,21,REDACTED
3005680,1,10,11,3,9,23,REDACTED
3005680,2,3,4,0,2,6,REDACTED
3005753,1,5,5,7,10,22,REDACTED
3005798,1,7,5,4,3,12,REDACTED
3005798,2,5,5,5,4,14,REDACTED
3005873,1,6,7,6,9,22,REDACTED
3006012,1,3,3,5,3,11,REDACTED
3006012,2,0,0,3,1,4,REDACTED
3006059,1,9,10,11,0,21,REDACTED
3006059,2,0,0,0,0,0,REDACTED
3006128,1,2,5,7,4,16,REDACTED
3006128,3,0,0,3,11,14,REDACTED
3006162,1,0,0,0,0,0,REDACTED
3006162,2,1,1,7,0,8,REDACTED
3006162,3,2,2,4,6,12,REDACTED
3006171,1,0,0,4,5,9,REDACTED
3006181,1,9,8,0,0,8,REDACTED
3006181,2,0,0,0,0,0,REDACTED
3006259,1,4,8,3,6,17,REDACTED
3006308,1,4,2,1,4,7,REDACTED
3006308,2,6,4,3,7,14,REDACTED
3006352,1,10,8,16,6,30,REDACTED
3006352,2,14,10,11,9,30,REDACTED
3006354,1,8,6,3,13,22,REDACTED
3006354,2,5,5,2,10,17,REDACTED
3006397,1,3,7,1,3,11,REDACTED
3006423,1,10,10,6,6,22,REDACTED
3006423,2,7,3,2,5,10,REDACTED
3006435,1,14,10,6,7,23,REDACTED
3006435,2,8,4,2,7,13,REDACTED
3006470,1,0,0,0,5,5,REDACTED
3006470,2,0,0,0,9,9,REDACTED
3006489,1,3,3,4,7,14,REDACTED
3006489,2,2,2,2,5,9,REDACTED
3006531,1,8,12,7,8,27,REDACTED
3006554,1,2,3,12,0,15,REDACTED
3006554,2,4,7,5,0,12,REDACTED
3006576,1,8,4,5,3,12,REDACTED
3006576,2,10,8,4,7,19,REDACTED
3006638,1,10,11,11,8,30,REDACTED
3006638,2,11,5,4,5,14,REDACTED
3006647,1,5,5,0,3,8,REDACTED
3006647,2,3,5,2,2,9,REDACTED
3006670,1,2,6,2,0,8,REDACTED
3006670,2,4,4,11,0,15,REDACTED
3006785,1,9,7,3,0,10,REDACTED
3006785,2,8,4,5,0,9,REDACTED
3006824,1,7,3,0,0,3,REDACTED
3006824,2,5,2,11,0,13,REDACTED
3006859,1,2,2,7,0,9,REDACTED
3006859,2,0,0,1,13,14,REDACTED
3006919,1,14,15,17,6,38,REDACTED
3006919,2,11,7,21,14,42,REDACTED
3006943,1,8,4,5,0,9,REDACTED
3006943,2,2,2,8,4,14,REDACTED
3006943,3,2,0,10,3,13,REDACTED
3007033,1,5,5,8,1,14,REDACTED
3007033,2,0,0,5,0,5,REDACTED
3007061,1,7,5,4,7,16,REDACTED
3007138,1,6,3,3,4,10,REDACTED
3007146,1,4,5,6,4,15,REDACTED
3007146,2,2,1,6,8,15,REDACTED
3007146,3,7,7,4,3,14,REDACTED
3007197,1,9,8,0,0,8,REDACTED
3007197,2,20,28,0,0,28,REDACTED
3007197,3,4,7,0,0,7,REDACTED
3007241,1,0,0,0,0,0,REDACTED
3007285,1,1,1,6,2,9,REDACTED
3007304,1,0,0,8,2,10,REDACTED
3007304,2,0,0,5,4,9,REDACTED
3007326,1,2,6,3,6,15,REDACTED
3007326,2,6,6,3,7,16,REDACTED
3007434,1,3,7,6,3,16,REDACTED
3007434,2,5,5,2,5,12,REDACTED
3007437,1,5,7,6,4,17,REDACTED
3007437,2,5,7,7,7,21,REDACTED
3007510,1,3,3,3,2,8,REDACTED
3007510,2,8,8,4,16,28,REDACTED
3007512,1,2,1,2,4,7,REDACTED
3007512,2,9,11,7,7,25,REDACTED
3007512,3,4,0,4,21,25,REDACTED
3007547,1,3,2,9,7,18,REDACTED
3007547,2,15,14,10,7,31,REDACTED
3007625,1,6,7,10,7,24,REDACTED
3007676,1,5,5,1,1,7,REDACTED
3007878,1,6,8,11,8,27,REDACTED
3007878,2,6,8,6,8,22,REDACTED
3007878,3,4,4,6,1,11,REDACTED
3007888,1,2,2,6,3,11,REDACTED
3007939,1,9,5,6,3,14,REDACTED
3007939,2,4,0,0,0,0,REDACTED
3007939,3,3,21,0,16,37,REDACTED
3007939,4,3,18,0,7,25,REDACTED
3008087,1,15,15,14,16,45,REDACTED
3008087,2,0,0,0,0,0,REDACTED
3008092,1,10,10,10,5,25,REDACTED
3008092,2,4,2,6,5,13,REDACTED
3008093,1,5,7,10,3,20,REDACTED
3008116,1,11,9,2,0,11,REDACTED
3008116,2,9,12,4,2,18,REDACTED
3008192,1,3,3,2,2,7,REDACTED
3008192,2,6,6,3,6,15,REDACTED
3008208,1,7,9,5,3,17,REDACTED
3008208,2,8,0,5,0,5,REDACTED
3008208,3,8,7,10,0,17,REDACTED
3008212,1,3,3,6,2,11,REDACTED
3008212,2,0,1,0,0,1,REDACTED
3008212,3,5,2,0,7,9,REDACTED
3008280,1,11,10,12,14,36,REDACTED
3008280,2,4,4,8,6,18,REDACTED
3008336,1,9,10,6,4,20,REDACTED
3008384,1,4,5,16,8,29,REDACTED
3008384,2,5,6,2,0,8,REDACTED
3008394,1,8,3,10,6,19,REDACTED
3008394,2,4,4,10,4,18,REDACTED
3008416,1,10,10,14,2,26,REDACTED
3008416,2,11,13,16,8,37,REDACTED
3008442,1,5,3,5,0,8,REDACTED
3008442,2,4,4,3,2,9,REDACTED
3008446,1,2,11,0,3,14,REDACTED
3008446,2,6,12,8,3,23,REDACTED
3008446,3,3,9,0,0,9,REDACTED
3008473,1,3,1,0,3,4,REDACTED
3008473,2,3,1,0,6,7,REDACTED
3008529,1,13,14,13,6,33,REDACTED
3008529,2,16,16,20,17,53,REDACTED
3008623,1,8,10,8,15,33,REDACTED
3008623,2,9,12,0,8,20,REDACTED
3008665,1,8,5,0,3,8,REDACTED
3008665,2,21,5,16,19,40,REDACTED
3008673,1,5,6,2,3,11,REDACTED
3008673,2,8,9,1,1,11,REDACTED
3008681,1,10,9,0,0,9,REDACTED
3008681,2,6,6,0,0,6,REDACTED
3008722,1,2,11,10,4,25,REDACTED
3008729,1,5,3,9,4,16,REDACTED
3008729,2,4,6,5,6,17,REDACTED
3008729,3,2,4,7,5,16,REDACTED
3008730,1,12,8,15,8,31,REDACTED
3008783,1,3,2,5,3,10,REDACTED
3008814,1,6,4,10,0,14,REDACTED
3008814,2,6,6,3,0,9,REDACTED
3008822,1,6,6,11,14,31,REDACTED
3008822,2,2,5,5,8,18,REDACTED
3008822,3,2,1,3,0,4,REDACTED
3008858,1,2,1,2,0,3,REDACTED
3008858,2,6,5,6,0,11,REDACTED
3008862,1,12,13,4,5,22,REDACTED
3008862,2,16,4,7,2,13,REDACTED
3008919,1,3,2,4,4,10,REDACTED
3008919,2,2,3,2,0,5,REDACTED
3008934,1,5,7,1,1,9,REDACTED
3008934,2,9,1,0,5,6,REDACTED
3009219,1,0,0,0,0,0,REDACTED
3009219,2,0,0,0,0,0,REDACTED
3009228,1,6,6,6,2,14,REDACTED
3009228,2,6,6,10,2,18,REDACTED
3009250,1,8,8,7,5,20,REDACTED
3009250,2,6,17,14,0,31,REDACTED
3009250,3,0,0,0,0,0,REDACTED
3009369,1,3,4,0,2,6,REDACTED
3009456,1,5,4,3,12,19,REDACTED
3009624,1,6,7,0,0,7,REDACTED
3009624,2,10,10,0,9,19,REDACTED
3010002,1,4,5,6,5,16,REDACTED
3010002,2,6,7,11,4,22,REDACTED
3010028,1,4,5,4,7,16,REDACTED
3010028,2,12,11,8,8,27,REDACTED
3010028,3,0,2,0,0,2,REDACTED
3010028,4,4,1,6,6,13,REDACTED
3010028,5,7,8,6,4,18,REDACTED
3010028,6,7,9,5,9,23,REDACTED
3010061,1,5,4,4,16,24,REDACTED
3010061,2,5,10,6,0,16,REDACTED
3010125,1,0,0,0,5,5,REDACTED
3010183,1,2,2,3,5,10,REDACTED
3010183,2,4,5,7,5,17,REDACTED
3010185,1,6,6,9,8,23,REDACTED
3010301,1,3,3,0,0,3,REDACTED
3010441,1,0,0,7,5,12,REDACTED
3010441,2,8,8,5,4,17,REDACTED
3010441,4,10,11,2,4,17,REDACTED
3010463,1,2,2,3,5,10,REDACTED
3010463,2,9,10,3,6,19,REDACTED
3010500,1,6,6,2,4,12,REDACTED
3010500,2,3,0,0,2,2,REDACTED
3010500,3,4,4,8,7,19,REDACTED
3010500,4,2,0,4,1,5,REDACTED
3010525,1,9,5,10,3,18,REDACTED
3010525,2,3,5,0,0,5,REDACTED
3010545,1,6,11,12,10,33,REDACTED
3010545,2,2,4,0,4,8,REDACTED
3010545,3,0,0,0,2,2,REDACTED
3010555,1,8,8,2,5,15,REDACTED
3010555,2,3,3,0,2,5,REDACTED
3010648,1,0,0,0,0,0,REDACTED
3010648,2,0,0,0,0,0,REDACTED
3010648,3,0,0,0,0,0,REDACTED
3010713,1,9,29,9,0,38,REDACTED
3010713,2,2,2,6,0,8,REDACTED
3010766,1,2,3,7,12,22,REDACTED
3010766,2,3,1,3,0,4,REDACTED
3010785,1,0,0,0,0,0,REDACTED
3010785,2,0,0,0,0,0,REDACTED
3010808,1,4,4,12,9,25,REDACTED
3010808,2,9,7,8,4,19,REDACTED
3012207,1,3,3,6,10,19,REDACTED
3012207,2,3,3,7,10,20,REDACTED
3012810,1,2,2,1,0,3,REDACTED
3012810,2,9,10,4,7,21,REDACTED
3012836,1,4,7,8,5,20,REDACTED
3012836,2,4,1,4,6,11,REDACTED
3012892,1,9,5,5,4,14,REDACTED
3012892,2,4,2,2,2,6,REDACTED
3012905,1,0,0,0,0,0,REDACTED
3012905,2,0,0,0,0,0,REDACTED
3013036,1,5,2,10,5,17,REDACTED
3013053,1,4,4,2,5,11,REDACTED
3013053,2,4,7,5,5,17,REDACTED
3013073,1,4,3,2,7,12,REDACTED
3013073,2,3,6,14,5,25,REDACTED
3013073,3,2,2,5,0,7,REDACTED
3013195,1,2,4,3,1,8,REDACTED
3013195,2,3,6,6,9,21,REDACTED
3013227,1,11,12,6,11,29,REDACTED
3013230,1,13,10,2,11,23,REDACTED
3013230,2,10,14,13,11,38,REDACTED
3013230,3,6,4,3,15,22,REDACTED
3013245,1,4,4,4,4,12,REDACTED
3013245,2,5,5,4,5,14,REDACTED
3013261,1,0,0,0,0,0,REDACTED
3013261,2,10,14,6,9,29,REDACTED
3013335,1,0,0,0,0,0,REDACTED
3013335,2,0,0,0,0,0,REDACTED
3013335,3,0,0,0,0,0,REDACTED
3013335,4,0,0,0,0,0,REDACTED
3013515,1,6,5,4,0,9,REDACTED
3013515,2,0,0,0,4,4,REDACTED
3013560,1,8,9,5,1,15,REDACTED
3013560,2,7,7,6,2,15,REDACTED
3013706,1,3,9,0,0,9,REDACTED
3013706,2,3,3,0,0,3,REDACTED
3013720,1,9,9,4,4,17,REDACTED
3013720,2,2,2,1,0,3,REDACTED
3013724,1,3,3,7,6,16,REDACTED
3013724,2,2,2,2,2,6,REDACTED
3013724,3,7,7,6,6,19,REDACTED
3013756,1,7,8,8,0,16,REDACTED
3013756,2,9,9,12,11,32,REDACTED
3013756,3,13,8,5,6,19,REDACTED
3013756,4,3,5,0,0,5,REDACTED
3013857,1,3,2,2,22,26,REDACTED
3013857,2,9,3,5,3,11,REDACTED
3013911,1,11,10,5,3,18,REDACTED
3013911,2,15,11,6,4,21,REDACTED
3013945,1,14,14,4,14,32,REDACTED
3013945,2,3,3,0,4,7,REDACTED
3013996,1,11,12,16,16,44,REDACTED
3013996,2,5,2,5,8,15,REDACTED
3013996,3,8,9,3,0,12,REDACTED
3014084,1,6,9,0,0,9,REDACTED
3014084,2,7,2,0,0,2,REDACTED
3014132,1,5,9,0,6,15,REDACTED
3014132,2,0,0,0,3,3,REDACTED
3014184,1,9,8,6,8,22,REDACTED
3014184,2,25,25,12,14,51,REDACTED
3014694,1,6,6,3,6,15,REDACTED
3014694,2,0,0,4,0,4,REDACTED
3014694,3,6,6,3,0,9,REDACTED
3014702,1,4,3,4,3,10,REDACTED
3014746,1,2,1,2,4,7,REDACTED
3014746,2,2,3,1,3,7,REDACTED
3014875,1,2,4,6,0,10,REDACTED
3014875,2,5,3,4,0,7,REDACTED
3015069,1,9,10,8,9,27,REDACTED
3015069,2,0,0,0,0,0,REDACTED
3015108,1,5,5,6,9,20,REDACTED
3015108,2,5,5,4,2,11,REDACTED
3015252,1,5,4,3,3,10,REDACTED
3015270,1,2,1,10,0,11,REDACTED
3015270,2,2,2,4,0,6,REDACTED
3015282,1,9,9,4,4,17,REDACTED
3015282,2,12,19,2,5,26,REDACTED
3015282,3,2,6,5,7,18,REDACTED
3015313,1,11,12,10,8,30,REDACTED
3015313,2,6,6,3,5,14,REDACTED
3015313,3,2,1,5,0,6,REDACTED
3015369,1,4,4,4,0,8,REDACTED
3015369,2,6,6,8,4,18,REDACTED
3015369,3,4,13,5,3,21,REDACTED
3015386,1,6,5,9,7,21,REDACTED
3015471,1,2,4,8,8,20,REDACTED
3015471,2,2,2,3,7,12,REDACTED
3015507,1,7,9,0,11,20,REDACTED
3015532,1,0,0,1,2,3,REDACTED
3015532,2,6,7,12,8,27,REDACTED
3015586,1,9,7,2,0,9,REDACTED
3015586,2,9,10,0,0,10,REDACTED
3015610,1,6,6,10,10,26,REDACTED
3015610,2,8,8,7,5,20,REDACTED
3015610,3,4,5,2,4,11,REDACTED
3015625,1,4,4,8,13,25,REDACTED
3015625,2,4,5,2,8,15,REDACTED
3015655,1,4,4,7,2,13,REDACTED
3015655,2,5,3,2,2,7,REDACTED
3015696,1,4,6,5,2,13,REDACTED
3015696,2,2,2,7,4,13,REDACTED
3015737,1,3,1,0,0,1,REDACTED
3015737,2,5,13,13,13,39,REDACTED
3015737,3,3,6,4,0,10,REDACTED
3015737,4,2,3,9,4,16,REDACTED
3015830,1,5,1,0,0,1,REDACTED
3015830,2,2,0,3,1,4,REDACTED
3015830,3,2,2,1,2,5,REDACTED
3015913,1,7,7,4,0,11,REDACTED
3015913,2,6,9,16,0,25,REDACTED
3016440,1,12,14,2,9,25,REDACTED
3016446,1,6,5,3,4,12,REDACTED
3016446,2,3,3,0,7,10,REDACTED
3016447,1,12,4,7,8,19,REDACTED
3016447,2,9,8,7,0,15,REDACTED
3016447,3,7,9,3,7,19,REDACTED
3016447,4,5,29,0,4,33,REDACTED
3016765,1,6,7,7,9,23,REDACTED
3016765,2,9,10,4,9,23,REDACTED
3016765,3,6,13,16,11,40,REDACTED
3016854,1,2,2,6,1,9,REDACTED
3016854,2,2,3,0,2,5,REDACTED
3016918,1,2,2,11,2,15,REDACTED
3016918,2,9,11,10,3,24,REDACTED
3016918,3,4,8,7,0,15,REDACTED
3016923,1,5,5,3,7,15,REDACTED
3016923,2,0,0,8,12,20,REDACTED
3016925,1,0,0,8,10,18,REDACTED
3016982,1,7,7,0,0,7,REDACTED
3017057,1,2,2,2,2,6,REDACTED
3017057,2,6,5,0,2,7,REDACTED
3017082,1,0,0,3,4,7,REDACTED
3017082,2,6,5,7,8,20,REDACTED
3017082,3,6,7,8,0,15,REDACTED
3017082,4,4,3,1,0,4,REDACTED
3017387,1,2,2,19,0,21,REDACTED
3017460,1,0,3,0,0,3,REDACTED
3017460,2,2,4,0,0,4,REDACTED
3017460,3,2,9,0,0,9,REDACTED
3017503,1,4,4,0,0,4,REDACTED
3017503,2,0,0,0,0,0,REDACTED
3017509,1,6,8,5,2,15,REDACTED
3017539,1,8,5,9,10,24,REDACTED
3017539,2,5,6,4,10,20,REDACTED
3017561,1,4,0,0,0,0,REDACTED
3017561,2,5,9,3,4,16,REDACTED
3017561,3,0,0,6,6,12,REDACTED
3017575,1,3,5,5,3,13,REDACTED
3017597,1,8,10,3,3,16,REDACTED
3017626,1,4,4,6,4,14,REDACTED
3017626,2,4,3,6,5,14,REDACTED
3017721,1,6,2,5,0,7,REDACTED
3017721,2,7,3,7,0,10,REDACTED
3017726,2,12,12,11,0,23,REDACTED
3017726,3,5,12,11,10,33,REDACTED
3017740,1,8,10,3,4,17,REDACTED
3017854,1,4,6,2,5,13,REDACTED
3017854,2,0,0,2,2,4,REDACTED
3017884,1,8,12,3,6,21,REDACTED
3017884,2,4,4,6,4,14,REDACTED
3017895,1,6,11,7,11,29,REDACTED
3017895,2,9,10,12,7,29,REDACTED
3017973,1,12,14,8,9,31,REDACTED
3017973,2,10,9,13,6,28,REDACTED
3018288,1,2,2,5,0,7,REDACTED
3018288,2,5,6,6,8,20,REDACTED
3018342,1,8,8,2,5,15,REDACTED
3018342,2,6,0,0,0,0,REDACTED
3018342,3,10,10,5,4,19,REDACTED
3018378,1,2,4,7,6,17,REDACTED
3018378,2,4,6,12,12,30,REDACTED
3018400,1,0,0,8,18,26,REDACTED
3018400,2,5,8,7,15,30,REDACTED
3018484,1,2,2,1,4,7,REDACTED
3018484,2,2,3,1,5,9,REDACTED
3018684,1,6,6,7,5,18,REDACTED
3018684,2,6,6,9,0,15,REDACTED
3018830,1,8,0,0,0,0,REDACTED
3018830,2,6,9,0,0,9,REDACTED
3018830,3,4,9,22,3,34,REDACTED
3018830,4,6,0,0,0,0,REDACTED
3019043,1,12,10,7,9,26,REDACTED
3019043,2,5,5,9,3,17,REDACTED
3019043,3,4,9,7,3,19,REDACTED
3019043,4,7,8,0,10,18,REDACTED
3019142,1,2,2,2,3,7,REDACTED
3019142,2,8,10,8,12,30,REDACTED
3019157,1,7,5,4,5,14,REDACTED
3019157,2,2,2,6,4,12,REDACTED
3019157,3,2,2,2,4,8,REDACTED
3019157,4,0,0,4,3,7,REDACTED
3019185,1,11,12,14,6,32,REDACTED
3019185,2,5,4,6,7,17,REDACTED
3019185,3,5,5,6,1,12,REDACTED
3019326,1,7,9,6,15,30,REDACTED
3019326,2,4,3,3,13,19,REDACTED
3019326,3,2,3,3,2,8,REDACTED
3019326,4,2,2,6,2,10,REDACTED
3019368,1,0,0,3,9,12,REDACTED
3019368,2,3,2,3,10,15,REDACTED
3019368,3,6,13,14,7,34,REDACTED
3019415,1,4,5,7,0,12,REDACTED
3019415,2,2,2,3,2,7,REDACTED
3019427,1,3,3,7,5,15,REDACTED
3019433,1,4,5,2,0,7,REDACTED
3019433,2,2,7,3,0,10,REDACTED
3019445,1,2,5,1,2,8,REDACTED
3019445,2,1,1,3,0,4,REDACTED
3019550,1,4,4,0,0,4,REDACTED
3019550,2,4,2,9,4,15,REDACTED
3019555,1,2,4,4,0,8,REDACTED
3019555,2,6,9,4,1,14,REDACTED
3019555,3,5,8,10,0,18,REDACTED
3019574,1,2,2,5,1,8,REDACTED
3019574,2,0,2,4,2,8,REDACTED
3019574,3,3,5,7,4,16,REDACTED
3019574,4,2,8,7,2,17,REDACTED
3019633,1,2,0,10,2,12,REDACTED
3019633,2,2,8,2,6,16,REDACTED
3019633,3,2,8,0,0,8,REDACTED
3019653,1,3,3,0,0,3,REDACTED
3019653,2,4,5,0,2,7,REDACTED
3019707,1,7,8,3,4,15,REDACTED
3019707,2,7,16,0,15,31,REDACTED
3019707,3,4,2,2,12,16,REDACTED
3019711,1,2,9,10,4,23,REDACTED
3019711,2,6,2,9,2,13,REDACTED
3019766,1,10,10,10,9,29,REDACTED
3019766,2,7,8,7,0,15,REDACTED
3019936,1,3,3,4,10,17,REDACTED
3019936,2,2,4,4,11,19,REDACTED
3019994,1,6,5,4,1,10,REDACTED
3019994,2,7,19,10,0,29,REDACTED
3019997,1,6,10,5,2,17,REDACTED
3019997,2,4,4,0,9,13,REDACTED
3020103,1,2,4,2,6,12,REDACTED
3020103,2,2,4,5,2,11,REDACTED
3020103,3,2,0,2,0,2,REDACTED
3020131,1,12,10,9,9,28,REDACTED
3020131,5,0,4,6,3,13,REDACTED
3020142,1,6,3,1,3,7,REDACTED
3020142,2,2,1,13,6,20,REDACTED
3020205,1,4,4,0,0,4,REDACTED
3020205,2,0,0,2,0,2,REDACTED
3020219,1,0,0,0,0,0,REDACTED
3020219,3,2,0,0,0,0,REDACTED
3020219,4,0,0,0,0,0,REDACTED
3020272,1,11,11,0,0,11,REDACTED
3020272,2,7,9,0,0,9,REDACTED
3020272,3,4,4,0,0,4,REDACTED
3020296,1,9,10,3,8,21,REDACTED
3020314,1,5,3,0,4,7,REDACTED
3020314,2,5,8,2,3,13,REDACTED
3020479,1,5,3,2,7,12,REDACTED
3020479,2,7,7,8,11,26,REDACTED
3020522,1,3,3,2,5,10,REDACTED
3020522,2,2,2,4,8,14,REDACTED
3020541,1,2,2,2,6,10,REDACTED
3020598,1,4,2,2,7,11,REDACTED
3020598,2,4,4,7,2,13,REDACTED
3020599,1,13,13,10,13,36,REDACTED
3020620,1,6,6,7,10,23,REDACTED
3020620,2,6,7,6,4,17,REDACTED
3020620,3,5,7,5,6,18,REDACTED
3020658,1,0,6,5,0,11,REDACTED
3020658,2,3,3,0,0,3,REDACTED
3020668,1,2,2,4,4,10,REDACTED
3020668,2,5,6,9,6,21,REDACTED
3020675,1,3,3,2,4,9,REDACTED
3020675,2,3,3,2,4,9,REDACTED
3020675,3,2,0,4,2,6,REDACTED
3020675,4,2,0,0,3,3,REDACTED
3020749,1,4,4,8,4,16,REDACTED
3020749,2,6,6,12,2,20,REDACTED
3020749,3,2,2,0,2,4,REDACTED
3020797,1,7,7,0,0,7,REDACTED
3020797,2,8,6,0,0,6,REDACTED
3020800,1,6,9,0,0,9,REDACTED
3020800,2,7,8,0,0,8,REDACTED
3020823,1,2,4,7,9,20,REDACTED
3020823,2,2,2,0,0,2,REDACTED
3020841,1,3,10,5,0,15,REDACTED
3020918,1,5,7,3,0,10,REDACTED
3020918,2,5,7,10,8,25,REDACTED
3020920,1,2,4,5,4,13,REDACTED
3020921,1,4,4,5,0,9,REDACTED
3020921,2,0,0,0,0,0,REDACTED
3020952,1,14,4,4,0,8,REDACTED
3020952,2,10,14,4,0,18,REDACTED
3020967,1,2,7,13,0,20,REDACTED
3020967,2,0,0,0,0,0,REDACTED
3020967,3,2,1,2,2,5,REDACTED
3020967,4,2,3,0,0,3,REDACTED
3021028,1,0,0,0,5,5,REDACTED
3021028,2,0,0,0,2,2,REDACTED
3021028,3,0,0,0,5,5,REDACTED
3021103,1,0,0,0,5,5,REDACTED
3021103,2,0,0,0,2,2,REDACTED
3021103,5,0,0,0,3,3,REDACTED
3021184,1,4,13,0,6,19,REDACTED
3021184,2,2,9,0,9,18,REDACTED
3021198,1,9,10,11,6,27,REDACTED
3021198,2,7,4,0,7,11,REDACTED
3021230,1,3,8,9,3,20,REDACTED
3021230,2,0,10,4,0,14,REDACTED
3021381,1,2,2,5,2,9,REDACTED
3021381,2,13,15,14,8,37,REDACTED
3021440,1,5,6,8,7,21,REDACTED
3021440,2,4,6,5,7,18,REDACTED
3021459,1,6,5,2,4,11,REDACTED
3021459,2,7,6,2,8,16,REDACTED
3021556,1,11,11,0,13,24,REDACTED
3021556,2,10,13,12,11,36,REDACTED
3021795,1,5,4,5,2,11,REDACTED
3021795,2,2,9,2,0,11,REDACTED
3021795,3,2,2,0,0,2,REDACTED
3021795,4,2,2,0,0,2,REDACTED
3021795,5,14,33,0,6,39,REDACTED
3021795,6,8,22,11,12,45,REDACTED
3021946,1,4,2,6,3,11,REDACTED
3021946,2,8,6,6,3,15,REDACTED
3021968,1,5,6,3,4,13,REDACTED
3021968,2,0,0,0,4,4,REDACTED
3022035,1,3,3,7,6,16,REDACTED
3022035,2,5,9,7,9,25,REDACTED
3022035,3,3,3,10,6,19,REDACTED
3022308,1,9,10,8,0,18,REDACTED
3022506,1,5,6,6,4,16,REDACTED
3022524,1,0,1,1,9,11,REDACTED
3022524,2,2,3,7,0,10,REDACTED
3022593,1,5,6,0,0,6,REDACTED
3022593,2,2,4,6,2,12,REDACTED
3022731,1,3,6,7,3,16,REDACTED
3022731,2,2,6,4,0,10,REDACTED
3022750,1,10,8,4,6,18,REDACTED
3022750,2,2,3,4,3,10,REDACTED
3022864,1,8,9,5,6,20,REDACTED
3023076,1,8,9,1,4,14,REDACTED
3023121,1,2,0,3,10,13,REDACTED
3023121,2,0,0,1,4,5,REDACTED
3023121,3,2,2,4,11,17,REDACTED
3023246,1,6,14,8,2,24,REDACTED
3023246,2,2,7,7,7,21,REDACTED
3023246,3,11,1,1,0,2,REDACTED
3023246,4,0,0,0,0,0,REDACTED
3023316,1,8,7,4,5,16,REDACTED
3023316,2,2,2,5,2,9,REDACTED
3023388,1,3,3,1,2,6,REDACTED
3023388,2,3,3,1,2,6,REDACTED
3023458,1,4,2,5,6,13,REDACTED
3023458,2,5,9,9,10,28,REDACTED
3023458,3,2,8,7,9,24,REDACTED
3023579,1,10,10,9,9,28,REDACTED
3023579,2,3,2,1,3,6,REDACTED
3023688,1,4,4,2,0,6,REDACTED
3023688,2,4,1,8,3,12,REDACTED
3023736,1,5,6,4,2,12,REDACTED
3023736,2,3,3,3,6,12,REDACTED
3023762,1,4,4,3,0,7,REDACTED
3023762,2,9,9,10,0,19,REDACTED
3023969,1,0,7,8,6,21,REDACTED
3023969,2,2,3,2,3,8,REDACTED
3023969,4,0,0,0,0,0,REDACTED
3024077,1,2,2,7,2,11,REDACTED
3024077,2,0,0,3,7,10,REDACTED
3024077,3,0,0,0,0,0,REDACTED
3034521,1,4,6,10,7,23,REDACTED
3051054,1,11,13,8,3,24,REDACTED
3051054,2,0,0,8,2,10,REDACTED
3051083,1,0,0,2,8,10,REDACTED
3051083,2,4,11,9,10,30,REDACTED
3051199,1,6,4,8,0,12,REDACTED
3051199,2,5,11,15,5,31,REDACTED
3051935,1,11,11,0,4,15,REDACTED
3051935,2,2,3,0,0,3,REDACTED
3051935,3,0,0,0,2,2,REDACTED
3055902,1,7,9,4,0,13,REDACTED
3055902,2,0,0,0,0,0,REDACTED
3056139,1,9,8,0,0,8,REDACTED
3056139,2,12,10,0,9,19,REDACTED
3056470,1,4,6,3,5,14,REDACTED
3056470,2,3,6,3,0,9,REDACTED
3056608,1,2,2,8,3,13,REDACTED
3056620,1,5,6,0,0,6,REDACTED
3056620,2,8,7,11,7,25,REDACTED
3056679,1,7,6,9,12,27,REDACTED
3056679,2,0,0,1,2,3,REDACTED
3056679,3,2,6,2,9,17,REDACTED
3056754,1,7,7,0,7,14,REDACTED
3056754,2,7,7,0,9,16,REDACTED
3056754,3,6,7,8,0,15,REDACTED
3056754,4,7,7,4,0,11,REDACTED
3056913,1,4,4,15,13,32,REDACTED
3056913,2,2,2,2,10,14,REDACTED
3057139,1,6,6,6,4,16,REDACTED
3057139,2,6,15,2,5,22,REDACTED
3057178,1,4,5,6,3,14,REDACTED
3057178,2,4,5,3,0,8,REDACTED
3057178,3,4,5,4,4,13,REDACTED
3057423,1,3,7,0,2,9,REDACTED
3057423,2,3,5,6,0,11,REDACTED
3072829,1,8,7,15,6,28,REDACTED
3072829,2,3,5,6,3,14,REDACTED
3072829,3,13,13,7,4,24,REDACTED
3081031,1,5,16,23,11,50,REDACTED
3081031,2,0,0,7,8,15,REDACTED
7007607,1,0,0,0,0,0,REDACTED
7007611,1,2,2,0,4,6,REDACTED
7007611,2,7,6,0,0,6,REDACTED
7007651,1,6,4,5,12,21,REDACTED
7007651,2,4,4,0,14,18,REDACTED
7007651,3,8,8,16,13,37,REDACTED
7007817,1,0,0,6,5,11,REDACTED
7007831,1,0,0,0,3,3,REDACTED
7007831,2,5,4,2,5,11,REDACTED
7007838,1,2,1,0,0,1,REDACTED
7007838,2,2,2,0,0,2,REDACTED
7007863,1,3,8,5,4,17,REDACTED
7007863,2,4,8,5,0,13,REDACTED
7007865,1,14,4,2,2,8,REDACTED
7007865,2,7,7,3,7,17,REDACTED
7007867,1,4,2,8,0,10,REDACTED
7007867,2,0,0,4,0,4,REDACTED
7007957,1,4,6,2,4,12,REDACTED
7007969,1,4,4,9,9,22,REDACTED
7007969,2,6,5,12,0,17,REDACTED
7008003,1,6,6,5,6,17,REDACTED
7008003,2,4,5,7,5,17,REDACTED
7008068,1,8,8,7,7,22,REDACTED
7008068,2,7,6,2,8,16,REDACTED
7008083,1,6,3,9,8,20,REDACTED
7008115,1,6,7,7,3,17,REDACTED
7008115,2,5,5,8,10,23,REDACTED
7008149,1,7,7,3,9,19,REDACTED
7008149,2,5,4,0,0,4,REDACTED
7009032,1,5,2,5,2,9,REDACTED
7009132,1,6,6,1,0,7,REDACTED
7009132,2,2,2,4,0,6,REDACTED
7009251,1,5,6,1,4,11,REDACTED
7009251,2,2,0,4,2,6,REDACTED
7009251,3,2,2,0,2,4,REDACTED
7009337,1,0,0,0,0,0,REDACTED
7009337,2,0,0,0,0,0,REDACTED
7009337,3,0,0,0,0,0,REDACTED
7009337,4,0,0,0,0,0,REDACTED
7009401,1,2,3,5,4,12,REDACTED
7009401,2,4,7,5,4,16,REDACTED
7009578,1,4,4,6,4,14,REDACTED
7009578,2,5,5,9,11,25,REDACTED
7009712,1,5,7,3,10,20,REDACTED
7009727,1,6,7,15,5,27,REDACTED
7009727,2,8,9,11,5,25,REDACTED
7009727,3,4,4,2,5,11,REDACTED
7009909,1,6,4,0,4,8,REDACTED
7009941,1,2,3,2,4,9,REDACTED
7009941,2,5,3,1,0,4,REDACTED
7009941,3,10,11,9,0,20,REDACTED
7009941,4,2,1,1,4,6,REDACTED
7009957,1,7,7,10,0,17,REDACTED
7010035,1,7,8,7,3,18,REDACTED
7010035,2,8,10,4,5,19,REDACTED
7010035,3,3,3,2,1,6,REDACTED
7010144,1,4,5,8,5,18,REDACTED
7010144,2,5,3,6,0,9,REDACTED
7010317,1,10,8,14,14,36,REDACTED
7010317,2,0,0,0,0,0,REDACTED
7010477,1,0,6,3,13,22,REDACTED
7010477,2,0,6,0,0,6,REDACTED
7010654,1,0,0,0,0,0,REDACTED
7010654,2,2,4,6,0,10,REDACTED
7010654,3,2,9,0,0,9,REDACTED
7010707,2,4,3,2,0,5,REDACTED
7010742,1,13,19,5,7,31,REDACTED
7010742,2,2,5,8,20,33,REDACTED
7010773,1,9,9,8,0,17,REDACTED
7010773,2,8,8,8,6,22,REDACTED
7010773,3,2,1,3,4,8,REDACTED
7011115,1,2,5,0,0,5,REDACTED
7011115,2,6,0,0,0,0,REDACTED
7011115,3,7,6,0,0,6,REDACTED
7011115,4,6,13,0,0,13,REDACTED
7011115,5,4,6,3,0,9,REDACTED
7011126,1,17,17,13,11,41,REDACTED
7011126,2,5,5,1,0,6,REDACTED
7011292,1,5,5,2,0,7,REDACTED
7011292,2,7,8,2,5,15,REDACTED
7011297,1,4,4,0,0,4,REDACTED
7011503,1,0,0,0,0,0,REDACTED
7011503,2,2,19,17,9,45,REDACTED
7011574,1,4,3,5,6,14,REDACTED
7011629,1,0,2,2,13,17,REDACTED
7011629,2,6,5,0,11,16,REDACTED
7011713,1,0,0,0,0,0,REDACTED
7011713,2,0,0,0,0,0,REDACTED
7011713,3,0,0,0,0,0,REDACTED
7011807,1,0,0,0,0,0,REDACTED
7011807,2,6,6,0,10,16,REDACTED
7011883,1,14,19,0,0,19,REDACTED
7011883,2,6,0,0,0,0,REDACTED
7011883,3,2,0,0,0,0,REDACTED
7011883,4,6,6,0,0,6,REDACTED
7011934,1,4,4,0,7,11,REDACTED
7011934,2,2,2,0,0,2,REDACTED
7011978,1,6,8,11,8,27,REDACTED
7011978,2,5,5,5,12,22,REDACTED
7012116,1,4,13,5,4,22,REDACTED
7012116,2,9,10,10,5,25,REDACTED
7012116,3,4,9,11,5,25,REDACTED
7012179,1,3,3,8,3,14,REDACTED
7012179,2,4,4,3,4,11,REDACTED
7012230,1,2,2,0,4,6,REDACTED
7012230,2,2,2,2,0,4,REDACTED
7012318,1,9,6,5,8,19,REDACTED
7012400,1,0,0,0,8,8,REDACTED
7012400,2,2,8,2,4,14,REDACTED
7012454,1,6,8,6,0,14,REDACTED
7012454,2,6,9,15,0,24,REDACTED
7012454,3,7,3,9,0,12,REDACTED
7012780,1,5,7,2,4,13,REDACTED
7012780,2,2,2,2,7,11,REDACTED
7012782,1,3,3,2,0,5,REDACTED
7012908,1,9,11,10,7,28,REDACTED
7012908,2,4,6,3,8,17,REDACTED
7012908,3,3,5,11,3,19,REDACTED
7012946,1,4,4,0,0,4,REDACTED
7013004,2,5,5,2,0,7,REDACTED
7013037,1,2,2,7,0,9,REDACTED
7013291,2,2,2,10,0,12,REDACTED
7013379,1,3,3,3,4,10,REDACTED
7013379,2,0,0,0,0,0,REDACTED
7013640,1,0,0,1,0,1,REDACTED
7013823,1,6,5,9,16,30,REDACTED
7014051,1,6,2,0,0,2,REDACTED
7014385,1,8,6,5,5,16,REDACTED
7014401,1,9,6,2,0,8,REDACTED
7014405,1,7,7,6,1,14,REDACTED
7014449,1,13,10,0,0,10,REDACTED
7014449,2,4,3,0,0,3,REDACTED
7014464,1,7,4,2,0,6,REDACTED
7014464,2,0,0,0,0,0,REDACTED
7014476,1,6,10,17,4,31,REDACTED
7014476,2,2,3,6,3,12,REDACTED
7014476,3,4,3,16,18,37,REDACTED
7014476,4,9,1,11,2,14,REDACTED
7014525,1,9,3,6,9,18,REDACTED
7014611,1,16,20,9,9,38,REDACTED
7014611,2,9,10,15,0,25,REDACTED
7014614,1,5,4,0,0,4,REDACTED
7014614,2,2,2,0,0,2,REDACTED
7014614,3,8,6,1,0,7,REDACTED
7014647,1,0,0,0,5,5,REDACTED
7014665,1,3,7,3,14,24,REDACTED
7014665,2,5,9,2,9,20,REDACTED
7014667,1,17,3,4,0,7,REDACTED
7014667,2,8,9,0,0,9,REDACTED
7014692,1,2,2,6,2,10,REDACTED
7014692,2,0,0,0,0,0,REDACTED
7014713,1,6,2,0,0,2,REDACTED
7014726,1,4,4,4,3,11,REDACTED
7014726,2,2,1,6,2,9,REDACTED
7014758,1,10,7,0,0,7,REDACTED
7014758,2,4,2,0,0,2,REDACTED
7015084,1,7,7,9,8,24,REDACTED
7015084,2,6,3,4,0,7,REDACTED
7015209,1,11,9,5,3,17,REDACTED
7015209,2,0,0,2,6,8,REDACTED
7015279,1,2,1,0,0,1,REDACTED
7015279,2,8,5,6,4,15,REDACTED
7015279,3,15,17,8,13,38,REDACTED
7015430,1,0,0,3,5,8,REDACTED
7015478,1,7,9,16,13,38,REDACTED
7015478,2,4,5,0,2,7,REDACTED
7015549,1,5,6,0,3,9,REDACTED
7015549,2,4,4,0,10,14,REDACTED
7015630,1,8,5,5,6,16,REDACTED
7015630,2,7,10,9,24,43,REDACTED
7015646,1,6,8,9,5,22,REDACTED
7015646,2,6,8,7,0,15,REDACTED
7015646,3,5,3,6,0,9,REDACTED
7015647,1,12,5,1,6,12,REDACTED
7015647,2,6,8,2,8,18,REDACTED
7016310,2,0,14,14,6,34,REDACTED
7016310,3,0,11,4,0,15,REDACTED
7016310,4,7,0,0,0,0,REDACTED
7016454,1,6,6,12,6,24,REDACTED
7016478,1,16,17,12,0,29,REDACTED
7016485,1,7,7,5,0,12,REDACTED
7016485,2,8,8,4,3,15,REDACTED
7016551,1,11,10,4,8,22,REDACTED
7016552,1,7,5,0,7,12,REDACTED
7016552,2,11,11,4,5,20,REDACTED
7016607,1,10,7,0,4,11,REDACTED
7016607,2,8,2,4,3,9,REDACTED
7016667,1,10,7,7,0,14,REDACTED
7016667,2,7,6,14,0,20,REDACTED
7016828,1,4,4,4,3,11,REDACTED
7016828,2,10,0,0,0,0,REDACTED
7016828,3,6,9,5,1,15,REDACTED
7016929,1,0,0,0,0,0,REDACTED
7016929,2,7,8,16,7,31,REDACTED
7016978,1,6,2,0,2,4,REDACTED
7016978,2,0,0,0,0,0,REDACTED
7017104,1,4,6,6,9,21,REDACTED
7017104,2,4,5,9,1,15,REDACTED
7017181,1,9,10,5,0,15,REDACTED
7017181,2,6,4,0,0,4,REDACTED
7017241,1,9,25,15,27,67,REDACTED
7017308,1,8,8,3,0,11,REDACTED
7017308,2,8,2,0,6,8,REDACTED
7017593,1,5,6,7,4,17,REDACTED
7017593,2,4,6,2,20,28,REDACTED
7017644,1,0,0,0,0,0,REDACTED
7017644,2,0,0,8,6,14,REDACTED
7017644,3,0,0,2,0,2,REDACTED
7017644,4,6,6,4,8,18,REDACTED
7017644,5,0,0,0,0,0,REDACTED
7017673,1,0,0,10,10,20,REDACTED
7017673,2,4,4,4,5,13,REDACTED
7018091,1,5,5,4,3,12,REDACTED
7018091,2,6,8,0,8,16,REDACTED
7018181,1,0,0,4,6,10,REDACTED
7018181,2,0,0,6,4,10,REDACTED
7018216,1,12,8,7,17,32,REDACTED
7018216,2,4,3,2,9,14,REDACTED
7018256,1,10,2,10,9,21,REDACTED
7018256,2,9,6,6,1,13,REDACTED
7018295,1,6,9,4,6,19,REDACTED
7018295,2,6,6,12,10,28,REDACTED
7018316,1,0,0,0,3,3,REDACTED
7018393,1,4,4,2,8,14,REDACTED
7018393,2,2,2,2,0,4,REDACTED
7018393,3,6,6,8,0,14,REDACTED
7018393,4,4,6,2,0,8,REDACTED
7018489,1,10,12,7,6,25,REDACTED
7018489,2,6,6,1,6,13,REDACTED
7018520,1,4,4,5,9,18,REDACTED
7018622,1,12,13,3,0,16,REDACTED
7018622,2,6,9,0,0,9,REDACTED
7018794,1,7,7,2,0,9,REDACTED
7018855,1,7,9,5,8,22,REDACTED
7018883,1,6,9,0,0,9,REDACTED
7018891,1,4,1,6,1,8,REDACTED
7018891,2,2,2,4,1,7,REDACTED
7018983,1,10,4,5,8,17,REDACTED
7018983,2,0,0,11,11,22,REDACTED
7018983,3,2,0,0,0,0,REDACTED
7019067,1,2,2,4,3,9,REDACTED
7019243,1,2,2,6,0,8,REDACTED
7019243,2,12,7,5,0,12,REDACTED
7019270,1,4,4,2,8,14,REDACTED
7019270,2,4,9,6,10,25,REDACTED
7019283,1,8,7,8,2,17,REDACTED
7019283,2,3,2,13,2,17,REDACTED
7019383,1,6,12,9,10,31,REDACTED
7019383,2,4,6,5,9,20,REDACTED
7019392,1,2,6,9,8,23,REDACTED
7019392,2,3,4,9,9,22,REDACTED
7019440,1,2,2,5,4,11,REDACTED
7019440,2,3,4,5,2,11,REDACTED
7019542,1,9,8,12,1,21,REDACTED
7019676,1,0,0,0,0,0,REDACTED
7019802,1,8,6,5,9,20,REDACTED
7019823,1,11,9,16,0,25,REDACTED
7019823,2,6,3,7,0,10,REDACTED
7019823,3,2,0,0,0,0,REDACTED
7019827,1,6,8,6,6,20,REDACTED
7019827,2,5,4,3,6,13,REDACTED
7019827,3,3,3,6,11,20,REDACTED
7019863,1,6,7,3,3,13,REDACTED
7019863,2,4,7,6,3,16,REDACTED
7019863,3,0,0,1,3,4,REDACTED
7020181,1,7,5,5,0,10,REDACTED
7020234,1,0,0,0,0,0,REDACTED
7020247,1,8,9,15,18,42,REDACTED
7020247,2,3,9,13,2,24,REDACTED
7020254,1,14,14,6,0,20,REDACTED
7020254,2,15,17,12,9,38,REDACTED
7020281,1,9,6,18,0,24,REDACTED
7020281,2,2,3,4,5,12,REDACTED
7020353,1,0,0,0,0,0,REDACTED
7020353,2,6,7,9,5,21,REDACTED
7020353,3,2,2,3,1,6,REDACTED
7020353,4,2,2,3,2,7,REDACTED
7020457,1,8,8,6,10,24,REDACTED
7020457,2,4,4,9,11,24,REDACTED
7020457,3,4,4,8,9,21,REDACTED
7020523,1,3,3,4,5,12,REDACTED
7020523,2,2,2,2,0,4,REDACTED
7020622,1,4,4,3,9,16,REDACTED
7020622,2,4,4,9,10,23,REDACTED
7020745,1,0,0,0,0,0,REDACTED
7020760,1,6,6,10,0,16,REDACTED
7020760,2,4,4,0,4,8,REDACTED
7020908,1,4,6,0,0,6,REDACTED
7020908,2,6,1,0,0,1,REDACTED
7157658,1,6,1,1,19,21,REDACTED
7157658,2,11,11,13,13,37,REDACTED
7157658,3,3,3,0,12,15,REDACTED
7157693,1,7,9,7,2,18,REDACTED
7157912,1,10,11,10,7,28,REDACTED
7157912,2,3,2,3,3,8,REDACTED
7157912,3,3,2,4,2,8,REDACTED
7157924,1,2,4,1,12,17,REDACTED
7157924,2,3,4,4,14,22,REDACTED
7158174,1,5,2,7,4,13,REDACTED
7158604,1,8,1,0,0,1,REDACTED
7158604,2,6,6,0,0,6,REDACTED
7158844,1,5,1,16,10,27,REDACTED
7158844,2,2,3,5,11,19,REDACTED
7158844,3,2,3,4,9,16,REDACTED
7158844,4,2,3,4,6,13,REDACTED
7158852,1,0,1,3,0,4,REDACTED
7158852,2,8,9,12,4,25,REDACTED
7158870,1,4,4,2,5,11,REDACTED
7158870,2,11,12,13,0,25,REDACTED
7158876,1,4,7,5,0,12,REDACTED
7158876,2,6,13,1,0,14,REDACTED
7158898,1,6,6,8,2,16,REDACTED
7158898,2,10,9,16,9,34,REDACTED
7158911,1,2,3,4,6,13,REDACTED
7158911,2,4,5,13,6,24,REDACTED
7158975,1,4,4,4,2,10,REDACTED
7158975,2,4,1,1,0,2,REDACTED
7159081,1,2,1,3,8,12,REDACTED
7159081,2,4,5,2,2,9,REDACTED
7159081,3,4,2,4,11,17,REDACTED
7159089,1,9,9,2,0,11,REDACTED
7159089,2,0,0,0,0,0,REDACTED
7159112,1,4,2,0,4,6,REDACTED
7159123,1,6,6,6,7,19,REDACTED
7159123,2,6,9,11,4,24,REDACTED
7159331,1,7,9,2,7,18,REDACTED
7159331,2,3,5,8,6,19,REDACTED
7159331,3,3,3,4,4,11,REDACTED
7159381,1,9,11,12,10,33,REDACTED
7159381,2,3,2,4,4,10,REDACTED
7159381,3,3,5,6,3,14,REDACTED
7159381,4,4,4,1,2,7,REDACTED
7159535,1,2,3,3,2,8,REDACTED
7159535,2,5,5,9,12,26,REDACTED
7159584,1,3,3,4,0,7,REDACTED
7159594,1,12,1,12,7,20,REDACTED
7159594,2,2,6,1,2,9,REDACTED
7159597,1,6,2,6,5,13,REDACTED
7159597,2,9,9,6,5,20,REDACTED
7159612,1,2,2,6,6,14,REDACTED
7159612,2,2,2,5,0,7,REDACTED
7159612,3,2,2,0,3,5,REDACTED
7159612,4,2,2,10,6,18,REDACTED
7159633,1,3,14,7,13,34,REDACTED
7159633,2,6,8,6,4,18,REDACTED
7159644,1,8,11,0,0,11,REDACTED
7159644,2,4,3,0,0,3,REDACTED
7159644,3,4,2,0,0,2,REDACTED
7159650,1,9,9,7,3,19,REDACTED
7159698,1,0,0,0,0,0,REDACTED
7159698,2,3,1,11,2,14,REDACTED
7159698,3,0,0,12,15,27,REDACTED
7159698,4,0,0,3,0,3,REDACTED
7159983,1,0,6,6,0,12,REDACTED
7159983,2,2,3,4,0,7,REDACTED
7160000,1,0,0,7,11,18,REDACTED
7160000,2,6,7,4,11,22,REDACTED
7160000,3,4,5,7,4,16,REDACTED
7160000,4,17,9,7,3,19,REDACTED
7160087,1,6,0,0,0,0,REDACTED
7160087,2,5,5,5,6,16,REDACTED
7160087,3,3,9,9,5,23,REDACTED
7160251,1,5,4,19,10,33,REDACTED
7160251,2,3,3,2,4,9,REDACTED
7160251,3,4,5,3,2,10,REDACTED
7160267,1,4,5,3,3,11,REDACTED
7160267,2,5,5,3,5,13,REDACTED
7160271,1,13,13,3,3,19,REDACTED
7160271,2,3,3,6,4,13,REDACTED
7160637,1,8,11,7,8,26,REDACTED
7160637,2,2,2,3,0,5,REDACTED
7160637,3,6,7,9,4,20,REDACTED
7161097,1,8,6,8,4,18,REDACTED
7161097,2,4,3,8,0,11,REDACTED
7161097,3,5,6,6,6,18,REDACTED
7161314,2,2,4,6,4,14,REDACTED
7161536,1,2,0,0,0,0,REDACTED
7161536,2,2,4,7,6,17,REDACTED
7161536,5,0,0,0,0,0,REDACTED
7161591,1,0,0,0,0,0,REDACTED
7161591,2,0,0,0,0,0,REDACTED
7161670,1,0,0,5,2,7,REDACTED
7161670,2,2,2,7,1,10,REDACTED
7161670,3,2,3,6,0,9,REDACTED
7161671,1,2,2,4,5,11,REDACTED
7161671,2,4,2,6,5,13,REDACTED
7161671,3,12,19,19,12,50,REDACTED
7161683,1,6,6,4,3,13,REDACTED
7161683,2,3,3,2,9,14,REDACTED
7161839,1,5,11,9,11,31,REDACTED
7161839,2,7,7,5,5,17,REDACTED
7161839,3,4,4,7,1,12,REDACTED
7161841,1,4,4,12,12,28,REDACTED
7161841,2,6,8,1,3,12,REDACTED
7161841,3,4,1,0,12,13,REDACTED
7161892,1,2,3,0,0,3,REDACTED
7161892,2,4,10,0,0,10,REDACTED
7161892,3,5,5,0,0,5,REDACTED
7161892,4,4,3,12,0,15,REDACTED
7162121,1,6,6,6,5,17,REDACTED
7162320,1,12,17,17,19,53,REDACTED
7162320,2,14,15,0,0,15,REDACTED
7162531,1,21,25,28,12,65,REDACTED
7162531,2,6,8,4,10,22,REDACTED
7162619,1,0,0,0,0,0,REDACTED
7162626,1,11,5,5,9,19,REDACTED
7162626,2,7,0,0,0,0,REDACTED
7162626,3,11,6,6,3,15,REDACTED
7162686,1,8,3,0,2,5,REDACTED
7162686,2,3,14,3,10,27,REDACTED
7162928,1,3,1,6,2,9,REDACTED
7162928,2,5,5,4,2,11,REDACTED
7162964,1,2,1,4,4,9,REDACTED
7162964,2,15,14,10,5,29,REDACTED
7162973,1,2,9,8,0,17,REDACTED
7163082,1,5,7,5,6,18,REDACTED
7163193,1,10,4,2,0,6,REDACTED
7163193,2,10,7,8,14,29,REDACTED
7163216,1,1,6,8,0,14,REDACTED
7163216,2,0,0,6,0,6,REDACTED
7163216,3,0,0,0,0,0,REDACTED
7163216,4,4,2,0,0,2,REDACTED
7163238,1,2,2,2,2,6,REDACTED
7163238,2,3,3,1,9,13,REDACTED
7163480,1,0,4,0,0,4,REDACTED
7163480,2,0,0,0,0,0,REDACTED
7163555,1,5,5,6,4,15,REDACTED
7163555,2,6,7,12,0,19,REDACTED
7163582,1,5,5,3,2,10,REDACTED
7163582,2,0,0,0,0,0,REDACTED
7163613,1,0,0,4,5,9,REDACTED
7163613,3,0,0,6,6,12,REDACTED
7163640,1,4,6,2,2,10,REDACTED
7163640,2,4,2,0,0,2,REDACTED
7163673,1,9,4,2,1,7,REDACTED
7163689,1,0,0,0,0,0,REDACTED
7163689,2,0,0,0,0,0,REDACTED
7163711,1,2,2,2,2,6,REDACTED
7163711,2,2,1,9,6,16,REDACTED
7163730,1,13,12,7,1,20,REDACTED
7163875,1,2,1,5,0,6,REDACTED
7163875,2,2,0,0,3,3,REDACTED
7163875,3,0,0,4,9,13,REDACTED
7163889,1,7,18,7,15,40,REDACTED
7163889,2,3,3,0,2,5,REDACTED
7163889,3,3,33,12,13,58,REDACTED
7163889,4,2,3,5,1,9,REDACTED
7164122,1,2,2,5,0,7,REDACTED
7164122,2,2,2,4,4,10,REDACTED
7164171,1,0,0,0,11,11,REDACTED
7164171,4,0,2,4,7,13,REDACTED
7164171,5,2,3,0,2,5,REDACTED
7164210,1,2,0,4,8,12,REDACTED
7164210,2,3,2,5,3,10,REDACTED
7164210,3,5,7,4,5,16,REDACTED
7164210,4,8,3,9,5,17,REDACTED
7164378,1,4,4,8,7,19,REDACTED
7164378,2,8,9,8,16,33,REDACTED
7164378,3,2,2,10,4,16,REDACTED
7164449,1,4,6,10,0,16,REDACTED
7164449,2,4,2,1,0,3,REDACTED
7164511,1,0,0,0,0,0,REDACTED
7164511,2,0,5,7,10,22,REDACTED
7164607,1,4,8,10,8,26,REDACTED
7164700,1,5,8,4,0,12,REDACTED
7164700,2,2,2,5,1,8,REDACTED
7164700,3,2,2,0,0,2,REDACTED
7164700,4,3,6,6,2,14,REDACTED
7164700,5,2,0,0,0,0,REDACTED
7164782,1,4,4,6,0,10,REDACTED
7164782,2,7,5,9,6,20,REDACTED
7164822,1,5,4,6,0,10,REDACTED
7164822,2,8,9,9,9,27,REDACTED
7164991,1,8,8,2,10,20,REDACTED
7164991,2,14,13,16,11,40,REDACTED
7165313,1,5,5,2,4,11,REDACTED
7165313,2,2,3,3,3,9,REDACTED
7165339,1,4,0,4,1,5,REDACTED
7165339,2,0,0,0,0,0,REDACTED
7165339,3,10,5,0,0,5,REDACTED
7165367,1,2,3,10,1,14,REDACTED
7165367,2,2,2,8,0,10,REDACTED
7165410,1,3,3,4,3,10,REDACTED
7165410,2,3,4,4,3,11,REDACTED
7165410,3,4,0,0,3,3,REDACTED
7165410,4,0,0,0,0,0,REDACTED
7165470,1,2,2,8,5,15,REDACTED
7165506,1,6,3,3,2,8,REDACTED
7165506,2,9,3,5,1,9,REDACTED
7165506,3,5,6,4,8,18,REDACTED
7165540,1,0,0,0,0,0,REDACTED
7165540,2,13,8,8,8,24,REDACTED
7165553,1,8,0,0,0,0,REDACTED
7165553,2,4,4,4,3,11,REDACTED
7165553,4,2,2,7,12,21,REDACTED
7165553,5,6,8,0,0,8,REDACTED
7165849,1,2,2,5,8,15,REDACTED
7165849,2,5,5,1,7,13,REDACTED
7165911,1,2,1,1,0,2,REDACTED
7165911,2,7,10,11,3,24,REDACTED
7165913,1,4,2,0,0,2,REDACTED
7165913,2,0,0,0,0,0,REDACTED
7165913,3,0,0,0,0,0,REDACTED
7165934,1,11,14,8,13,35,REDACTED
7165934,2,7,8,4,8,20,REDACTED
7165941,1,4,4,10,13,27,REDACTED
7165941,2,10,22,4,13,39,REDACTED
7165941,3,4,5,3,12,20,REDACTED
7165943,1,2,2,0,14,16,REDACTED
7165943,2,2,2,1,0,3,REDACTED
7165943,3,5,9,0,7,16,REDACTED
7165949,1,6,7,7,4,18,REDACTED
7165949,2,24,26,15,23,64,REDACTED
7165949,3,5,1,0,9,10,REDACTED
7165950,1,4,3,2,4,9,REDACTED
7165950,2,3,5,1,4,10,REDACTED
7165950,3,3,10,2,0,12,REDACTED
7165950,4,2,3,6,4,13,REDACTED
7166084,1,4,7,3,6,16,REDACTED
7166084,2,4,6,7,7,20,REDACTED
7166412,1,11,11,4,7,22,REDACTED
7166412,2,8,6,4,6,16,REDACTED
7166412,3,10,12,8,0,20,REDACTED
7166412,4,4,0,3,2,5,REDACTED
7166528,1,6,3,2,3,8,REDACTED
7166678,1,10,10,14,0,24,REDACTED
7166678,2,4,3,3,9,15,REDACTED
7166678,3,5,5,1,0,6,REDACTED
7166712,1,5,6,15,7,28,REDACTED
7166712,2,4,8,4,7,19,REDACTED
7166712,3,4,4,6,5,15,REDACTED
7166726,1,2,6,2,5,13,REDACTED
7166734,1,2,6,2,6,14,REDACTED
7166734,2,6,6,4,6,16,REDACTED
7166784,1,7,7,4,2,13,REDACTED
7166784,2,7,8,0,8,16,REDACTED
7166940,1,0,0,8,7,15,REDACTED
7166940,2,0,0,7,3,10,REDACTED
7167047,1,0,0,20,2,22,REDACTED
7167047,2,3,4,0,1,5,REDACTED
7167047,3,6,8,0,8,16,REDACTED
7167047,4,6,8,4,12,24,REDACTED
7167056,1,5,5,8,4,17,REDACTED
7167056,2,17,13,5,8,26,REDACTED
7167056,3,0,0,11,4,15,REDACTED
7167073,1,4,7,4,12,23,REDACTED
7167073,2,7,7,4,5,16,REDACTED
7167369,1,9,3,17,2,22,REDACTED
7167369,2,0,0,0,0,0,REDACTED
7167369,3,1,0,0,0,0,REDACTED
7167369,4,4,0,0,0,0,REDACTED
7167399,1,2,2,2,1,5,REDACTED
7167399,2,19,17,13,9,39,REDACTED
7167696,1,0,0,5,4,9,REDACTED
7167696,2,2,3,4,3,10,REDACTED
7167828,1,4,5,0,3,8,REDACTED
7167828,2,8,14,7,8,29,REDACTED
7168171,1,6,4,7,3,14,REDACTED
7168171,2,4,4,2,0,6,REDACTED
7168171,3,9,10,2,0,12,REDACTED
7168201,1,2,2,0,0,2,REDACTED
7168201,2,0,0,0,0,0,REDACTED
7168253,1,2,3,3,0,6,REDACTED
7168253,2,2,2,3,4,9,REDACTED
7168253,3,0,0,0,0,0,REDACTED
7168253,4,2,0,0,0,0,REDACTED
7168253,5,4,2,2,0,4,REDACTED
7168413,1,2,2,2,0,4,REDACTED
7168413,2,2,1,1,0,2,REDACTED
7168634,1,6,10,7,10,27,REDACTED
7168634,2,6,3,7,4,14,REDACTED
7168825,1,2,2,2,3,7,REDACTED
7168825,2,0,0,2,0,2,REDACTED
7168837,1,8,8,9,5,22,REDACTED
7168837,2,7,14,11,11,36,REDACTED
7168885,1,6,2,5,2,9,REDACTED
7168885,2,5,6,20,0,26,REDACTED
7168885,3,5,6,8,4,18,REDACTED
7168918,1,16,17,5,14,36,REDACTED
7168918,2,4,5,8,13,26,REDACTED
7168930,1,8,9,0,17,26,REDACTED
7168930,2,3,1,2,4,7,REDACTED
7169014,1,13,15,10,2,27,REDACTED
7169014,2,2,4,4,4,12,REDACTED
7169014,3,8,8,0,0,8,REDACTED
7169022,1,7,7,3,0,10,REDACTED
7169022,2,3,4,6,2,12,REDACTED
7169022,3,4,5,0,0,5,REDACTED
7169097,1,17,16,12,11,39,REDACTED
7169097,2,9,7,6,0,13,REDACTED
7169097,3,6,8,5,6,19,REDACTED
7169169,1,2,2,5,10,17,REDACTED
7169169,2,4,4,0,0,4,REDACTED
7169202,1,0,0,0,0,0,REDACTED
7169280,1,3,3,1,0,4,REDACTED
7169280,2,2,1,4,0,5,REDACTED
7169283,1,9,13,0,7,20,REDACTED
7169283,2,0,0,0,0,0,REDACTED
7169283,3,2,4,0,0,4,REDACTED
7169283,4,5,7,0,4,11,REDACTED
7169400,1,8,8,8,9,25,REDACTED
7169400,2,7,7,5,7,19,REDACTED
7169400,3,3,1,3,5,9,REDACTED
7169467,1,2,2,1,5,8,REDACTED
7169467,2,2,3,1,0,4,REDACTED
7169467,3,0,0,0,0,0,REDACTED
7169557,1,2,4,3,2,9,REDACTED
7169557,2,2,5,1,4,10,REDACTED
7169594,1,3,3,0,5,8,REDACTED
7169594,2,6,6,0,0,6,REDACTED
7169686,1,4,0,8,11,19,REDACTED
7169686,2,2,5,5,0,10,REDACTED
7169686,3,0,2,11,1,14,REDACTED
7169686,4,0,4,8,0,12,REDACTED
7169768,1,9,9,0,0,9,REDACTED
7169768,2,9,8,0,0,8,REDACTED
7169816,1,2,0,6,2,8,REDACTED
7169816,2,0,5,0,4,9,REDACTED
7169816,3,7,11,5,8,24,REDACTED
7169831,1,9,10,10,8,28,REDACTED
7169831,2,2,2,2,4,8,REDACTED
7169847,1,9,11,6,3,20,REDACTED
7169847,2,2,13,12,0,25,REDACTED
7169847,3,0,0,4,0,4,REDACTED
7169857,1,11,7,11,0,18,REDACTED
7169857,2,2,2,5,9,16,REDACTED
7169857,3,0,0,0,0,0,REDACTED
7169958,1,4,3,0,0,3,REDACTED
7169958,2,4,3,0,0,3,REDACTED
7169975,1,0,0,0,4,4,REDACTED
7169975,2,0,0,1,4,5,REDACTED
7169975,3,2,0,0,2,2,REDACTED
7169975,4,2,0,1,2,3,REDACTED
7170059,1,9,3,5,4,12,REDACTED
7170059,2,10,4,0,5,9,REDACTED
7170338,1,0,0,0,0,0,REDACTED
7170338,2,0,0,0,0,0,REDACTED
7170338,3,0,0,0,0,0,REDACTED
7170513,1,0,11,11,10,32,REDACTED
7170513,2,10,5,6,4,15,REDACTED
7170585,1,6,8,18,0,26,REDACTED
7170585,2,2,0,0,0,0,REDACTED
7170585,3,0,0,5,12,17,REDACTED
7170585,4,0,6,0,0,6,REDACTED
7170585,5,6,5,7,0,12,REDACTED
7170665,1,0,0,0,0,0,REDACTED
7170665,2,7,6,2,0,8,REDACTED
7170667,1,15,24,18,20,62,REDACTED
7170724,1,0,0,10,0,10,REDACTED
7170724,2,2,2,10,0,12,REDACTED
7170742,1,5,5,3,1,9,REDACTED
7170742,2,7,7,10,2,19,REDACTED
7170782,1,10,12,7,5,24,REDACTED
7170783,1,9,5,5,7,17,REDACTED
7170783,2,0,0,0,0,0,REDACTED
7170790,1,5,2,13,2,17,REDACTED
7170790,2,7,7,3,11,21,REDACTED
7170848,1,6,5,5,1,11,REDACTED
7170848,2,3,3,8,4,15,REDACTED
7170848,3,0,0,0,6,6,REDACTED
7170872,2,13,18,20,5,43,REDACTED
7170902,1,9,10,5,9,24,REDACTED
7170902,2,6,6,12,4,22,REDACTED
7170935,1,3,0,2,4,6,REDACTED
7170935,2,5,3,0,2,5,REDACTED
7170935,3,7,4,1,2,7,REDACTED
7170955,1,0,0,2,4,6,REDACTED
7170955,3,2,4,0,0,4,REDACTED
7170955,4,2,0,0,0,0,REDACTED
7170955,5,0,0,0,0,0,REDACTED
7170972,1,2,3,2,17,22,REDACTED
7171084,1,4,5,0,2,7,REDACTED
7171105,1,9,10,11,8,29,REDACTED
7171105,2,0,10,10,8,28,REDACTED
7171105,3,6,4,15,8,27,REDACTED
7171115,1,7,9,0,0,9,REDACTED
7171151,1,8,8,8,3,19,REDACTED
7171151,2,3,2,1,0,3,REDACTED
7171151,3,8,11,0,4,15,REDACTED
7171151,4,5,3,0,0,3,REDACTED
7171171,1,4,2,3,0,5,REDACTED
7171171,2,0,0,0,0,0,REDACTED
7171171,3,0,0,6,0,6,REDACTED
7171285,1,9,0,11,1,12,REDACTED
7171285,2,4,4,3,3,10,REDACTED
7171285,3,8,8,9,8,25,REDACTED
7171285,4,4,4,3,4,11,REDACTED
7171313,1,8,9,13,7,29,REDACTED
7171313,2,12,5,13,13,31,REDACTED
7171313,3,8,3,7,12,22,REDACTED
7171417,1,8,8,23,10,41,REDACTED
7171417,2,12,8,24,12,44,REDACTED
7171417,3,10,0,1,0,1,REDACTED
7171720,1,5,3,3,5,11,REDACTED
7171785,1,0,0,6,8,14,REDACTED
7171785,2,0,0,0,0,0,REDACTED
7171843,1,6,6,4,7,17,REDACTED
7171843,2,3,3,10,8,21,REDACTED
7172005,1,3,5,8,4,17,REDACTED
7172005,2,3,4,6,3,13,REDACTED
7172182,1,0,0,1,0,1,REDACTED
7172182,2,0,0,20,0,20,REDACTED
7172619,1,5,5,3,3,11,REDACTED
7172619,2,4,3,2,2,7,REDACTED
7172669,1,7,8,11,0,19,REDACTED
7172669,2,4,3,2,16,21,REDACTED
7172669,3,2,3,3,4,10,REDACTED
7172749,1,5,8,12,4,24,REDACTED
7172749,2,7,10,11,10,31,REDACTED
7172815,1,9,9,7,3,19,REDACTED
7172815,2,8,8,11,4,23,REDACTED
7172815,3,4,4,5,8,17,REDACTED
7172858,1,4,2,2,0,4,REDACTED
7172858,2,8,8,7,7,22,REDACTED
7172939,1,2,3,8,2,13,REDACTED
7172939,2,10,11,7,8,26,REDACTED
7173128,1,3,1,5,5,11,REDACTED
7173353,1,15,8,4,5,17,REDACTED
7173609,1,2,2,2,1,5,REDACTED
7173614,1,3,2,4,4,10,REDACTED
7173614,3,12,16,18,16,50,REDACTED
7173630,1,5,6,6,10,22,REDACTED
7173630,2,8,8,7,6,21,REDACTED
7173641,1,0,0,2,0,2,REDACTED
7173641,2,6,3,8,3,14,REDACTED
7173661,1,5,0,9,0,9,REDACTED
7173661,2,5,1,11,2,14,REDACTED
7173661,3,2,1,8,0,9,REDACTED
7173692,1,5,9,7,8,24,REDACTED
7173692,2,4,4,1,9,14,REDACTED
7173692,3,2,0,16,5,21,REDACTED
7173697,1,7,9,7,4,20,REDACTED
7173697,2,0,0,2,0,2,REDACTED
7173816,1,0,0,0,5,5,REDACTED
7173816,2,0,0,0,3,3,REDACTED
7173816,3,0,0,0,3,3,REDACTED
7173816,4,0,0,0,2,2,REDACTED
7173816,5,0,0,0,4,4,REDACTED
7173942,1,3,3,2,2,7,REDACTED
7173942,2,6,7,0,2,9,REDACTED
7173942,3,6,4,0,0,4,REDACTED
7174066,1,11,9,6,5,20,REDACTED
7174066,2,6,10,11,0,21,REDACTED
7174066,3,2,2,0,5,7,REDACTED
7174066,4,2,1,4,0,5,REDACTED
7174325,1,6,6,2,0,8,REDACTED
7174325,2,2,3,9,7,19,REDACTED
7174325,3,8,9,2,0,11,REDACTED
7174360,1,3,1,7,0,8,REDACTED
7174360,2,4,10,9,4,23,REDACTED
7174520,1,5,6,6,6,18,REDACTED
7174520,2,3,5,2,3,10,REDACTED
7174586,1,5,15,19,0,34,REDACTED
7174586,2,2,2,8,0,10,REDACTED
7174586,3,3,8,1,0,9,REDACTED
7174619,1,2,2,3,5,10,REDACTED
7174619,2,4,5,6,5,16,REDACTED
7174619,3,0,0,0,5,5,REDACTED
7174619,4,2,3,4,5,12,REDACTED
7174634,1,4,4,6,6,16,REDACTED
7174634,2,2,3,2,3,8,REDACTED
7174634,3,3,4,8,4,16,REDACTED
7174634,4,8,16,12,9,37,REDACTED
7174634,5,2,13,13,15,41,REDACTED
7174667,1,3,3,0,4,7,REDACTED
7174667,2,3,3,0,3,6,REDACTED
7174667,3,3,3,1,4,8,REDACTED
7175017,1,4,4,5,3,12,REDACTED
7175017,2,4,7,8,6,21,REDACTED
7175017,3,2,0,1,1,2,REDACTED
7175017,4,8,4,1,2,7,REDACTED
7175153,1,6,10,3,0,13,REDACTED
7175153,2,4,2,6,0,8,REDACTED
7175185,1,0,0,0,0,0,REDACTED
7175185,2,0,0,0,0,0,REDACTED
7175185,3,6,0,0,0,0,REDACTED
7175193,1,11,10,8,16,34,REDACTED
7175193,2,6,7,0,5,12,REDACTED
7175219,1,4,6,0,12,18,REDACTED
7175219,2,11,11,0,10,21,REDACTED
7175219,3,5,9,0,5,14,REDACTED
7176001,1,0,0,3,0,3,REDACTED
7176001,2,13,16,3,12,31,REDACTED
7176001,3,10,18,0,16,34,REDACTED
7176070,1,6,5,4,1,10,REDACTED
7176180,1,12,9,1,1,11,REDACTED
7176180,2,5,5,5,4,14,REDACTED
7176485,1,2,13,8,2,23,REDACTED
7176485,2,2,2,1,0,3,REDACTED
7176485,3,2,12,2,0,14,REDACTED
7176665,1,2,3,3,3,9,REDACTED
7176665,2,2,1,7,2,10,REDACTED
7176665,3,2,5,0,0,5,REDACTED
7176724,1,8,8,13,4,25,REDACTED
7176751,1,0,0,0,0,0,REDACTED
7176751,2,0,0,0,0,0,REDACTED
7176763,1,2,4,2,0,6,REDACTED
7176763,2,8,8,9,5,22,REDACTED
7177534,1,4,13,5,0,18,REDACTED
7177539,1,7,22,6,2,30,REDACTED
7177612,1,5,5,5,2,12,REDACTED
7177639,1,7,5,4,6,15,REDACTED
7177639,2,11,13,12,10,35,REDACTED
7177639,3,3,7,11,0,18,REDACTED
7177673,1,3,4,1,3,8,REDACTED
7177746,1,19,17,3,4,24,REDACTED
7177787,1,6,4,11,10,25,REDACTED
7177787,2,0,0,0,0,0,REDACTED
7177876,1,2,3,9,1,13,REDACTED
7177876,2,5,2,9,4,15,REDACTED
7177920,1,6,4,0,2,6,REDACTED
7177920,2,2,3,0,1,4,REDACTED
7177980,1,8,9,7,0,16,REDACTED
7177980,2,7,4,3,0,7,REDACTED
7178056,1,9,9,8,2,19,REDACTED
7178122,1,12,10,8,0,18,REDACTED
7178131,1,13,13,11,19,43,REDACTED
7178131,2,4,3,1,0,4,REDACTED
7178171,1,6,4,6,2,12,REDACTED
7178223,1,14,12,19,0,31,REDACTED
7178328,1,8,5,7,5,17,REDACTED
7178343,1,8,8,12,0,20,REDACTED
7178395,1,11,10,9,5,24,REDACTED
7178395,2,9,12,6,5,23,REDACTED
7178406,1,5,4,15,4,23,REDACTED
7178406,2,8,4,10,4,18,REDACTED
7178415,1,8,8,6,4,18,REDACTED
7178415,2,12,13,9,7,29,REDACTED
7178422,1,7,8,2,0,10,REDACTED
7178422,2,2,2,0,0,2,REDACTED
7178422,3,7,7,5,5,17,REDACTED
7178497,1,6,7,0,4,11,REDACTED
7178497,2,12,0,13,12,25,REDACTED
7178497,3,6,2,2,9,13,REDACTED
7178497,4,4,14,4,9,27,REDACTED
7178630,1,6,9,0,0,9,REDACTED
7178630,2,2,6,4,3,13,REDACTED
7178630,6,6,9,0,0,9,REDACTED
7178653,1,8,0,0,0,0,REDACTED
7178653,2,7,0,0,3,3,REDACTED
7178653,3,0,0,0,0,0,REDACTED
7178653,4,4,7,0,0,7,REDACTED
7178801,1,8,10,18,7,35,REDACTED
7178801,2,2,2,3,2,7,REDACTED
7178807,1,0,4,4,0,8,REDACTED
7178807,2,0,0,0,0,0,REDACTED
7178807,3,0,0,0,0,0,REDACTED
7178807,4,0,0,0,0,0,REDACTED
7178807,5,0,3,3,3,9,REDACTED
7178857,1,4,18,9,4,31,REDACTED
7178857,2,0,0,0,12,12,REDACTED
7178866,1,2,1,3,8,12,REDACTED
7178895,1,8,5,7,7,19,REDACTED
7178895,2,3,3,0,2,5,REDACTED
7178895,3,2,0,2,2,4,REDACTED
7178928,1,9,21,18,1,40,REDACTED
7178966,1,5,4,5,10,19,REDACTED
7178966,2,10,9,5,6,20,REDACTED
7178966,3,4,4,10,10,24,REDACTED
7178984,1,4,4,4,7,15,REDACTED
7178984,2,4,2,5,6,13,REDACTED
7179019,1,2,2,9,9,20,REDACTED
7179019,2,6,4,10,6,20,REDACTED
7179124,1,2,1,6,0,7,REDACTED
7179124,2,2,3,11,2,16,REDACTED
7179124,3,3,5,1,2,8,REDACTED
7179124,4,4,5,8,11,24,REDACTED
7179124,5,0,0,0,0,0,REDACTED
7179128,1,5,5,4,5,14,REDACTED
7179168,1,14,6,7,7,20,REDACTED
7179168,2,2,2,2,5,9,REDACTED
7179172,1,5,6,15,2,23,REDACTED
7179176,1,2,2,0,0,2,REDACTED
7179176,2,4,5,4,5,14,REDACTED
7179185,1,9,9,7,2,18,REDACTED
7179246,1,0,0,0,0,0,REDACTED
7179246,2,8,5,0,0,5,REDACTED
7179288,1,8,7,7,7,21,REDACTED
7179288,2,4,3,3,3,9,REDACTED
7179304,1,16,17,18,0,35,REDACTED
7179304,2,5,3,0,0,3,REDACTED
7179323,1,7,13,5,7,25,REDACTED
7179323,2,9,10,6,2,18,REDACTED
7179323,3,5,1,1,3,5,REDACTED
7179323,4,5,1,12,1,14,REDACTED
7179323,5,6,10,1,0,11,REDACTED
7179330,1,8,8,0,1,9,REDACTED
7179330,2,0,0,0,0,0,REDACTED
7179390,1,14,16,3,9,28,REDACTED
7179390,2,12,5,0,0,5,REDACTED
7179405,1,9,4,4,10,18,REDACTED
7179405,2,6,7,4,5,16,REDACTED
7179405,3,9,9,3,1,13,REDACTED
7179448,1,5,5,5,3,13,REDACTED
7179499,1,2,2,7,2,11,REDACTED
7179499,2,15,16,0,15,31,REDACTED
7179522,1,8,6,2,4,12,REDACTED
7179522,2,6,0,0,0,0,REDACTED
7179522,3,6,3,4,1,8,REDACTED
7179530,1,8,6,8,18,32,REDACTED
7179530,2,8,6,0,2,8,REDACTED
7179530,3,8,11,1,10,22,REDACTED
7179622,1,2,3,5,19,27,REDACTED
7179622,2,11,17,13,12,42,REDACTED
7179676,1,5,9,8,0,17,REDACTED
7179676,2,7,9,8,0,17,REDACTED
7179676,3,5,0,9,0,9,REDACTED
7179680,1,4,6,2,6,14,REDACTED
7179680,2,3,2,4,0,6,REDACTED
7179680,3,4,5,15,3,23,REDACTED
7179718,1,0,0,0,0,0,REDACTED
7179743,1,0,0,2,4,6,REDACTED
7179743,2,0,0,5,2,7,REDACTED
7179906,1,6,6,0,0,6,REDACTED
7179906,2,2,2,0,0,2,REDACTED
7179965,1,8,5,0,0,5,REDACTED
7179965,2,8,8,0,6,14,REDACTED
7179965,3,2,3,2,4,9,REDACTED
7179965,4,2,3,2,2,7,REDACTED
7180115,1,4,7,7,0,14,REDACTED
7180115,2,3,5,0,0,5,REDACTED
7180174,1,10,13,19,15,47,REDACTED
7180532,1,2,12,2,7,21,REDACTED
7180532,2,2,9,0,0,9,REDACTED
7180621,1,6,0,2,0,2,REDACTED
7180621,2,3,1,4,10,15,REDACTED
7180621,3,2,3,6,6,15,REDACTED
7180621,4,6,4,7,4,15,REDACTED
7180719,1,2,3,6,0,9,REDACTED
7180719,2,6,9,4,0,13,REDACTED
7180741,1,2,2,3,6,11,REDACTED
7180741,2,2,2,5,6,13,REDACTED
7180741,3,2,3,5,2,10,REDACTED
7180937,1,18,19,13,10,42,REDACTED
7180937,2,6,6,10,9,25,REDACTED
7180962,1,10,12,0,0,12,REDACTED
7180962,2,6,8,0,0,8,REDACTED
7180962,3,6,7,0,0,7,REDACTED
7181016,1,6,6,14,9,29,REDACTED
7181016,2,4,0,0,0,0,REDACTED
7181016,3,1,10,1,0,11,REDACTED
7181016,4,4,0,0,0,0,REDACTED
7181021,1,11,11,16,6,33,REDACTED
7181021,2,14,14,11,7,32,REDACTED
7181056,1,2,1,5,13,19,REDACTED
7181056,2,6,2,3,10,15,REDACTED
7181101,1,4,4,5,7,16,REDACTED
7181101,2,8,8,8,10,26,REDACTED
7181110,1,4,7,6,4,17,REDACTED
7181110,2,2,1,8,6,15,REDACTED
7181110,3,3,10,5,0,15,REDACTED
7181171,1,7,7,9,3,19,REDACTED
7181171,2,5,7,5,4,16,REDACTED
7181182,1,3,3,5,4,12,REDACTED
7181182,2,14,9,9,9,27,REDACTED
7181195,1,4,4,3,3,10,REDACTED
7181195,2,11,11,20,11,42,REDACTED
7181195,3,10,12,6,10,28,REDACTED
7181406,1,6,5,2,3,10,REDACTED
7181497,1,3,3,6,0,9,REDACTED
7181497,2,3,1,7,0,8,REDACTED
7181656,1,3,3,3,2,8,REDACTED
7181656,2,4,4,5,2,11,REDACTED
7182018,1,0,0,0,0,0,REDACTED
7182018,2,4,0,3,0,3,REDACTED
7182018,3,2,1,15,0,16,REDACTED
7182134,1,8,8,9,5,22,REDACTED
7182134,2,6,4,2,6,12,REDACTED
7182141,1,0,0,5,4,9,REDACTED
7182141,2,2,0,7,4,11,REDACTED
7182141,3,0,0,0,0,0,REDACTED
7182437,1,2,2,0,0,2,REDACTED
7182437,2,2,2,0,0,2,REDACTED
7182631,1,2,3,8,7,18,REDACTED
7182631,2,2,11,9,0,20,REDACTED
7182668,1,8,10,2,9,21,REDACTED
7182688,1,0,0,0,0,0,REDACTED
7182719,1,2,2,13,5,20,REDACTED
7182719,4,7,8,2,0,10,REDACTED
7182719,5,2,0,1,0,1,REDACTED
7182760,1,2,0,2,5,7,REDACTED
7182760,2,2,4,7,11,22,REDACTED
7182760,3,2,3,2,0,5,REDACTED
7182760,4,2,0,4,18,22,REDACTED
7182990,1,0,0,19,2,21,REDACTED
7182990,2,0,0,0,0,0,REDACTED
7182990,3,0,0,17,0,17,REDACTED
7182990,4,0,0,17,2,19,REDACTED
7183113,1,10,10,8,0,18,REDACTED
7183113,2,6,6,2,0,8,REDACTED
7183154,1,6,6,10,5,21,REDACTED
7183154,2,7,7,0,8,15,REDACTED
7183291,1,4,6,0,0,6,REDACTED
7183291,2,4,2,0,0,2,REDACTED
7183291,3,4,2,0,0,2,REDACTED
7183353,1,0,0,0,0,0,REDACTED
7183353,2,0,0,0,0,0,REDACTED
7183353,3,0,0,0,0,0,REDACTED
7183388,1,2,2,10,12,24,REDACTED
7183388,2,2,8,10,12,30,REDACTED
7183388,3,2,15,9,12,36,REDACTED
7183391,1,7,3,4,0,7,REDACTED
7183391,2,7,8,11,10,29,REDACTED
7183391,3,4,9,7,2,18,REDACTED
7183425,1,3,3,2,5,10,REDACTED
7183425,2,3,3,3,6,12,REDACTED
7183626,1,8,8,4,0,12,REDACTED
7183626,2,2,1,2,3,6,REDACTED
7183626,3,0,0,2,3,5,REDACTED
7183626,4,2,2,2,4,8,REDACTED
7184134,1,5,2,5,0,7,REDACTED
7184134,2,2,7,4,10,21,REDACTED
7184134,3,0,0,7,0,7,REDACTED
7184134,4,3,4,0,0,4,REDACTED
7184251,1,12,13,10,10,33,REDACTED
7184251,2,19,26,12,8,46,REDACTED
7184251,3,8,8,4,10,22,REDACTED
7184298,1,10,10,7,8,25,REDACTED
7184298,2,10,11,6,0,17,REDACTED
7184326,1,6,10,0,7,17,REDACTED
7184326,2,2,1,2,4,7,REDACTED
7184326,3,5,10,0,0,10,REDACTED
7184326,4,3,10,4,1,15,REDACTED
7184369,1,3,4,6,0,10,REDACTED
7184369,2,3,5,6,0,11,REDACTED
7184375,1,0,0,0,1,1,REDACTED
7184375,2,0,0,0,0,0,REDACTED
7184375,3,2,7,6,2,15,REDACTED
7184482,1,7,6,7,6,19,REDACTED
7184482,3,7,6,4,7,17,REDACTED
7184482,4,5,5,4,8,17,REDACTED
7184562,1,6,6,5,0,11,REDACTED
7184562,2,4,5,7,8,20,REDACTED
7184563,1,0,0,0,0,0,REDACTED
7184563,2,0,0,0,0,0,REDACTED
7184563,3,0,0,0,0,0,REDACTED
7184662,1,7,7,3,6,16,REDACTED
7184662,2,7,7,5,2,14,REDACTED
7184662,3,2,2,4,1,7,REDACTED
7184662,4,4,2,2,2,6,REDACTED
7184680,1,5,5,5,9,19,REDACTED
7184680,2,8,6,9,2,17,REDACTED
7184695,1,0,6,3,18,27,REDACTED
7184695,2,0,9,0,17,26,REDACTED
7184733,1,5,7,1,0,8,REDACTED
7184806,1,2,2,1,12,15,REDACTED
7184806,2,15,16,5,4,25,REDACTED
7184867,1,7,7,0,7,14,REDACTED
7184867,2,7,1,0,9,10,REDACTED
7184867,3,5,5,2,1,8,REDACTED
7184881,1,0,0,0,0,0,REDACTED
7184912,1,15,17,8,12,37,REDACTED
7184912,2,2,2,2,0,4,REDACTED
7184912,3,10,14,0,0,14,REDACTED
7184984,1,6,6,9,14,29,REDACTED
7184984,2,7,12,8,11,31,REDACTED
7185352,1,4,3,3,4,10,REDACTED
7185352,2,4,4,3,4,11,REDACTED
7185352,3,4,3,3,7,13,REDACTED
7185513,1,11,12,11,10,33,REDACTED
7185513,2,2,7,2,9,18,REDACTED
7185513,3,7,4,1,0,5,REDACTED
7185575,1,6,7,12,18,37,REDACTED
7185575,2,7,7,3,9,19,REDACTED
7185575,3,3,16,15,14,45,REDACTED
7185575,4,8,7,11,4,22,REDACTED
7185575,5,2,2,9,5,16,REDACTED
7185614,1,7,0,3,0,3,REDACTED
7185614,2,2,2,6,0,8,REDACTED
7185614,3,10,13,4,4,21,REDACTED
7185622,1,9,9,7,4,20,REDACTED
7185622,2,7,20,0,0,20,REDACTED
7185622,3,7,16,13,3,32,REDACTED
7185680,1,2,2,3,1,6,REDACTED
7185680,2,2,2,0,2,4,REDACTED
7185901,1,0,8,0,10,18,REDACTED
7185901,2,0,2,4,10,16,REDACTED
7185901,3,0,7,0,10,17,REDACTED
7185903,1,2,2,9,2,13,REDACTED
7185903,2,11,13,7,6,26,REDACTED
7185903,3,8,8,7,6,21,REDACTED
7185903,4,3,3,2,8,13,REDACTED
7185908,1,4,2,6,0,8,REDACTED
7185908,2,3,0,5,0,5,REDACTED
7185908,3,4,2,0,0,2,REDACTED
7185908,4,3,6,0,0,6,REDACTED
7186202,1,0,0,0,0,0,REDACTED
7186202,2,0,0,0,0,0,REDACTED
7186303,1,5,5,7,3,15,REDACTED
7186314,1,5,5,13,0,18,REDACTED
7186319,1,7,7,9,0,16,REDACTED
7186319,2,2,3,3,7,13,REDACTED
7186441,1,2,5,4,0,9,REDACTED
7186441,2,0,0,0,0,0,REDACTED
7186441,3,2,0,0,0,0,REDACTED
7186441,4,2,0,0,0,0,REDACTED
7186792,1,11,12,6,0,18,REDACTED
7186792,2,3,4,4,0,8,REDACTED
7186828,1,5,5,7,7,19,REDACTED
7186828,2,8,6,6,4,16,REDACTED
7187026,1,0,0,11,0,11,REDACTED
7187026,2,2,4,6,0,10,REDACTED
7187026,3,4,6,3,24,33,REDACTED
7187026,4,9,9,6,7,22,REDACTED
7187045,1,2,0,7,8,15,REDACTED
7187045,2,3,1,6,18,25,REDACTED
7187045,3,4,13,6,9,28,REDACTED
7187462,1,5,5,7,7,19,REDACTED
7187462,2,13,7,0,0,7,REDACTED
7187462,3,0,8,0,0,8,REDACTED
7187462,4,0,0,0,0,0,REDACTED
7187511,1,3,3,7,11,21,REDACTED
7187511,2,3,1,0,0,1,REDACTED
7187517,1,2,2,4,5,11,REDACTED
7187517,2,2,1,1,2,4,REDACTED
7187517,3,0,0,0,0,0,REDACTED
7187629,1,6,8,9,3,20,REDACTED
7187629,2,3,6,8,7,21,REDACTED
7187756,1,6,3,4,9,16,REDACTED
7187756,2,0,0,0,0,0,REDACTED
7187843,1,5,9,8,10,27,REDACTED
7187843,2,10,8,0,7,15,REDACTED
7187850,1,4,3,2,3,8,REDACTED
7187850,2,4,9,13,2,24,REDACTED
7187850,3,4,4,10,5,19,REDACTED
7188795,1,0,7,5,6,18,REDACTED
7188795,2,4,8,4,8,20,REDACTED
7189099,1,7,7,9,2,18,REDACTED
7189099,2,4,26,8,0,34,REDACTED
7189099,3,4,4,1,4,9,REDACTED
7189099,4,11,11,6,3,20,REDACTED
7189349,1,3,4,6,0,10,REDACTED
7189349,2,5,5,5,5,15,REDACTED
7189545,1,11,10,8,7,25,REDACTED
7189545,2,11,8,3,8,19,REDACTED
7189614,1,0,0,0,0,0,REDACTED
7189644,1,7,25,1,9,35,REDACTED
7189644,2,14,7,15,9,31,REDACTED
7189764,1,6,3,13,0,16,REDACTED
7189764,2,2,1,12,0,13,REDACTED
7189809,1,6,6,7,0,13,REDACTED
7189809,2,2,2,3,0,5,REDACTED
7189829,1,8,4,4,4,12,REDACTED
7189845,1,5,11,4,0,15,REDACTED
7189866,1,4,2,1,2,5,REDACTED
7189866,2,2,0,2,2,4,REDACTED
7189866,3,0,0,0,0,0,REDACTED
7189866,4,6,7,2,4,13,REDACTED
7189908,1,4,4,7,3,14,REDACTED
7189908,2,4,4,0,0,4,REDACTED
7189942,1,4,4,5,4,13,REDACTED
7189955,1,6,7,1,0,8,REDACTED
7189955,2,7,6,2,0,8,REDACTED
7189956,1,8,4,4,6,14,REDACTED
7190069,1,7,9,6,10,25,REDACTED
7190069,2,9,9,16,4,29,REDACTED
7190092,1,7,7,7,4,18,REDACTED
7190092,2,9,9,1,6,16,REDACTED
7190143,1,6,6,6,6,18,REDACTED
7190143,2,2,3,1,2,6,REDACTED
7190185,1,10,7,7,6,20,REDACTED
7190185,2,6,5,4,0,9,REDACTED
7190185,3,5,7,2,6,15,REDACTED
7190185,4,6,2,3,6,11,REDACTED
7190234,1,10,14,4,4,22,REDACTED
7190234,2,4,5,5,5,15,REDACTED
7190252,1,7,7,6,8,21,REDACTED
7190252,2,12,5,9,6,20,REDACTED
7190370,1,2,2,1,0,3,REDACTED
7190370,2,0,0,0,0,0,REDACTED
7190421,1,0,0,0,0,0,REDACTED
7190421,2,4,1,0,0,1,REDACTED
7190428,1,7,9,4,7,20,REDACTED
7190428,2,7,9,14,9,32,REDACTED
7190428,3,6,9,5,5,19,REDACTED
7190468,1,3,4,0,6,10,REDACTED
7190468,2,5,6,0,0,6,REDACTED
7190560,1,6,6,9,6,21,REDACTED
7190560,2,8,10,9,2,21,REDACTED
7190560,3,2,2,5,2,9,REDACTED
7190685,1,10,7,7,10,24,REDACTED
7190685,2,8,5,5,2,12,REDACTED
7190958,1,3,3,4,7,14,REDACTED
7190958,2,4,7,3,0,10,REDACTED
7191159,1,9,5,8,2,15,REDACTED
7191159,2,2,0,5,2,7,REDACTED
7191159,3,2,2,4,5,11,REDACTED
7191165,1,6,5,7,0,12,REDACTED
7191165,2,2,2,6,2,10,REDACTED
7191165,3,9,6,6,2,14,REDACTED
7191212,1,6,11,0,0,11,REDACTED
7191212,2,3,4,3,0,7,REDACTED
7191233,1,2,2,6,7,15,REDACTED
7191277,2,4,6,0,4,10,REDACTED
7191319,1,11,12,26,0,38,REDACTED
7191319,2,13,16,1,0,17,REDACTED
7191319,3,14,33,29,0,62,REDACTED
7191340,1,9,20,4,7,31,REDACTED
7191340,2,0,0,0,0,0,REDACTED
7191340,5,0,0,0,0,0,REDACTED
7191362,1,4,4,0,5,9,REDACTED
7191362,2,4,4,0,5,9,REDACTED
7191362,3,2,5,3,5,13,REDACTED
7191518,1,8,4,4,2,10,REDACTED
7191526,1,5,10,6,0,16,REDACTED
7191633,1,8,8,0,11,19,REDACTED
7191633,2,8,5,13,19,37,REDACTED
7191724,1,6,3,4,0,7,REDACTED
7191724,2,4,5,6,3,14,REDACTED
7191987,1,3,1,0,2,3,REDACTED
7191987,2,2,3,0,2,5,REDACTED
7191987,3,0,0,0,3,3,REDACTED
7192017,1,2,3,0,0,3,REDACTED
7192017,2,6,3,0,0,3,REDACTED
7192053,1,5,5,5,4,14,REDACTED
7192079,1,4,4,1,13,18,REDACTED
7192079,2,0,0,0,0,0,REDACTED
7192079,3,5,5,10,0,15,REDACTED
7192159,1,0,0,0,0,0,REDACTED
7192159,2,4,10,6,11,27,REDACTED
7192226,1,9,3,3,9,15,REDACTED
7192226,2,4,4,3,2,9,REDACTED
7192272,1,3,3,3,2,8,REDACTED
7192272,2,0,0,9,9,18,REDACTED
7192296,1,6,0,0,0,0,REDACTED
7192296,2,0,0,0,0,0,REDACTED
7192296,3,0,0,0,0,0,REDACTED
7192373,1,2,7,22,2,31,REDACTED
7192435,1,8,11,10,1,22,REDACTED
7192435,2,0,0,0,0,0,REDACTED
7192525,1,2,2,4,0,6,REDACTED
7192529,1,6,6,7,6,19,REDACTED
7192529,2,5,5,3,7,15,REDACTED
7192546,1,8,8,7,7,22,REDACTED
7192546,2,10,8,5,0,13,REDACTED
7192552,1,3,5,0,0,5,REDACTED
7192644,1,6,6,2,12,20,REDACTED
7192644,2,4,4,4,14,22,REDACTED
7192710,1,4,2,5,2,9,REDACTED
7192710,2,13,7,5,12,24,REDACTED
7192710,3,2,8,6,0,14,REDACTED
7192740,1,8,10,3,2,15,REDACTED
7192740,2,2,3,2,2,7,REDACTED
7192746,1,11,6,6,6,18,REDACTED
7192746,2,7,4,4,4,12,REDACTED
7192803,1,3,3,9,4,16,REDACTED
7192803,2,5,6,3,4,13,REDACTED
7192803,3,4,5,13,0,18,REDACTED
7192803,4,3,3,8,8,19,REDACTED
7192807,1,4,4,6,1,11,REDACTED
7192807,2,7,8,2,5,15,REDACTED
7192817,1,0,1,4,4,9,REDACTED
7192817,2,17,19,10,17,46,REDACTED
7192817,3,18,18,6,17,41,REDACTED
7192817,4,3,4,2,4,10,REDACTED
7192818,1,2,2,6,2,10,REDACTED
7192818,2,3,3,2,1,6,REDACTED
7192829,1,4,4,3,1,8,REDACTED
7192829,2,2,2,3,1,6,REDACTED
7192873,1,4,3,9,5,17,REDACTED
7192873,3,2,2,0,0,2,REDACTED
7192972,1,9,8,13,3,24,REDACTED
7192972,2,2,2,8,1,11,REDACTED
7192972,3,3,1,5,3,9,REDACTED
7193056,1,4,4,5,9,18,REDACTED
7193056,2,6,6,5,11,22,REDACTED
7193104,1,0,0,0,0,0,REDACTED
7193104,2,0,0,0,0,0,REDACTED
7193104,3,0,0,0,0,0,REDACTED
7193133,1,2,0,0,0,0,REDACTED
7193133,2,6,8,4,10,22,REDACTED
7193133,3,6,6,3,0,9,REDACTED
7193166,1,0,0,7,5,12,REDACTED
7193166,2,3,2,4,3,9,REDACTED
7193178,1,2,6,2,3,11,REDACTED
7193178,2,2,7,2,5,14,REDACTED
7193192,1,4,9,3,3,15,REDACTED
7193239,1,6,7,9,4,20,REDACTED
7193239,2,0,0,8,0,8,REDACTED
7193311,1,0,0,0,0,0,REDACTED
7193341,1,4,11,9,7,27,REDACTED
7193341,2,3,7,3,1,11,REDACTED
7193388,1,2,2,2,0,4,REDACTED
7193564,1,3,2,6,3,11,REDACTED
7193564,2,3,6,4,3,13,REDACTED
7193564,3,2,10,0,0,10,REDACTED
7193577,1,9,14,4,0,18,REDACTED
7193577,2,8,7,5,6,18,REDACTED
7193590,1,6,8,7,4,19,REDACTED
7193590,2,8,14,13,10,37,REDACTED
7193590,3,0,0,0,3,3,REDACTED
7193639,1,15,14,13,10,37,REDACTED
7193639,2,15,10,1,0,11,REDACTED
7193639,3,5,6,17,0,23,REDACTED
7193775,1,8,12,7,8,27,REDACTED
7193775,2,0,10,2,13,25,REDACTED
7193910,1,4,2,13,0,15,REDACTED
7193925,1,8,8,3,1,12,REDACTED
7193925,2,11,10,10,0,20,REDACTED
7193971,1,2,4,0,0,4,REDACTED
7193971,2,2,2,0,7,9,REDACTED
7194193,1,3,3,2,2,7,REDACTED
7194193,2,4,4,2,6,12,REDACTED
7194193,3,4,0,0,0,0,REDACTED
7194320,1,5,9,3,0,12,REDACTED
7194320,5,2,2,3,3,8,REDACTED
7194320,6,2,11,10,13,34,REDACTED
7194421,1,6,5,6,6,17,REDACTED
7194421,2,4,5,4,2,11,REDACTED
7194493,1,2,2,3,7,12,REDACTED
7194493,2,2,6,6,5,17,REDACTED
7194582,1,8,0,1,0,1,REDACTED
7194582,2,10,12,6,0,18,REDACTED
7194582,8,9,5,9,0,14,REDACTED
7194787,1,4,5,3,4,12,REDACTED
7194787,2,5,5,7,0,12,REDACTED
7194787,3,2,5,2,2,9,REDACTED
7194787,4,2,1,5,0,6,REDACTED
7194856,1,6,12,11,7,30,REDACTED
7194856,2,3,9,0,0,9,REDACTED
7194886,1,5,0,0,0,0,REDACTED
7194886,2,0,0,0,0,0,REDACTED
7194886,3,0,0,0,0,0,REDACTED
7195164,1,4,10,4,6,20,REDACTED
7195195,1,6,6,4,6,16,REDACTED
7195195,2,7,5,3,8,16,REDACTED
7195368,1,10,2,4,5,11,REDACTED
7195368,2,6,7,0,5,12,REDACTED
7195418,1,5,2,2,0,4,REDACTED
7195418,2,9,10,5,0,15,REDACTED
7195418,3,4,4,5,16,25,REDACTED
7195441,1,6,4,1,3,8,REDACTED
7195441,2,4,7,0,2,9,REDACTED
7195608,1,10,7,10,2,19,REDACTED
7195608,2,3,5,4,1,10,REDACTED
7195679,1,0,0,0,0,0,REDACTED
7195828,1,0,0,0,0,0,REDACTED
7195828,2,0,0,0,0,0,REDACTED
7195867,3,6,7,0,0,7,REDACTED
7195972,1,3,3,3,3,9,REDACTED
7195972,2,6,8,7,6,21,REDACTED
7196031,1,0,0,2,12,14,REDACTED
7196031,2,10,7,8,5,20,REDACTED
7196032,1,2,2,3,0,5,REDACTED
7196229,1,5,5,2,6,13,REDACTED
7196229,2,3,3,13,9,25,REDACTED
7196229,3,2,3,0,1,4,REDACTED
7196297,1,12,13,9,7,29,REDACTED
7196297,2,11,12,13,9,34,REDACTED
7196313,1,6,0,0,0,0,REDACTED
7196313,2,0,7,4,2,13,REDACTED
7196313,3,0,0,0,0,0,REDACTED
7196466,1,2,4,2,5,11,REDACTED
7196466,2,5,9,2,6,17,REDACTED
7196632,1,3,4,10,13,27,REDACTED
7196632,2,4,8,5,2,15,REDACTED
7196632,3,3,7,3,0,10,REDACTED
7196632,4,2,5,6,0,11,REDACTED
7196646,1,7,3,5,4,12,REDACTED
7196646,2,9,8,2,0,10,REDACTED
7196649,1,2,2,0,6,8,REDACTED
7196649,2,2,11,4,1,16,REDACTED
7196754,1,2,0,1,1,2,REDACTED
7196754,2,8,11,4,3,18,REDACTED
7196754,3,8,9,13,6,28,REDACTED
7196754,4,2,2,0,0,2,REDACTED
7196961,1,3,4,4,0,8,REDACTED
7197128,1,5,5,0,6,11,REDACTED
7197128,2,0,3,5,5,13,REDACTED
7197211,1,4,4,9,0,13,REDACTED
7197211,2,7,7,0,0,7,REDACTED
7197213,1,0,3,5,6,14,REDACTED
7197213,2,0,2,14,4,20,REDACTED
7197213,3,0,4,2,2,8,REDACTED
7197283,1,0,0,0,0,0,REDACTED
7197319,1,4,1,1,0,2,REDACTED
7197758,1,3,4,0,0,4,REDACTED
7197758,2,2,1,0,0,1,REDACTED
7197758,3,0,9,0,13,22,REDACTED
7197758,4,0,0,0,0,0,REDACTED
7197809,1,5,5,7,0,12,REDACTED
7197837,1,11,11,6,4,21,REDACTED
7197915,1,9,9,11,1,21,REDACTED
7198004,1,6,5,0,0,5,REDACTED
7198004,2,6,7,0,0,7,REDACTED
7198017,1,4,11,10,5,26,REDACTED
7198017,2,0,0,7,5,12,REDACTED
7198859,1,14,15,9,9,33,REDACTED
7198916,1,4,4,2,3,9,REDACTED
7199227,1,9,11,0,0,11,REDACTED
7199353,1,7,7,12,15,34,REDACTED
7199393,1,9,10,7,7,24,REDACTED
7199393,2,5,5,7,7,19,REDACTED
7199444,1,7,8,1,3,12,REDACTED
7199452,1,2,5,6,1,12,REDACTED
7199452,2,0,5,3,1,9,REDACTED
7199487,1,6,2,0,0,2,REDACTED
7199487,2,4,2,0,0,2,REDACTED
7199487,3,0,0,0,0,0,REDACTED
7199487,4,0,0,0,0,0,REDACTED
7199487,5,4,12,0,0,12,REDACTED
7199666,1,5,5,3,7,15,REDACTED
7199666,2,10,10,6,6,22,REDACTED
7199666,3,0,0,0,0,0,REDACTED
7199674,1,4,4,5,0,9,REDACTED
7199674,2,3,3,9,5,17,REDACTED
7199674,3,0,0,5,0,5,REDACTED
7199674,4,4,5,8,2,15,REDACTED
7199674,5,2,2,1,0,3,REDACTED
7199867,1,5,5,8,3,16,REDACTED
7199909,1,6,5,10,8,23,REDACTED
7199909,2,3,3,2,3,8,REDACTED
7199932,1,6,6,2,6,14,REDACTED
7199932,2,11,12,8,9,29,REDACTED
7199963,1,2,2,0,5,7,REDACTED
7199963,2,2,2,1,5,8,REDACTED
7200003,1,3,6,6,3,15,REDACTED
7200003,2,2,3,1,5,9,REDACTED
7200037,1,8,5,5,0,10,REDACTED
7200037,2,4,4,7,7,18,REDACTED
7200156,1,3,4,4,4,12,REDACTED
7200156,2,9,15,17,13,45,REDACTED
7200333,1,4,6,4,3,13,REDACTED
7200333,2,2,2,10,0,12,REDACTED
7200404,1,7,8,12,8,28,REDACTED
7200404,2,0,0,5,0,5,REDACTED
7200404,3,2,1,2,5,8,REDACTED
7200404,4,5,7,0,8,15,REDACTED
7200423,1,4,4,0,0,4,REDACTED
7200423,2,0,0,0,0,0,REDACTED
7200621,1,5,6,3,5,14,REDACTED
7200639,1,8,10,6,2,18,REDACTED
7200639,2,8,10,0,3,13,REDACTED
7200670,1,5,4,3,7,14,REDACTED
7200670,2,7,9,5,10,24,REDACTED
7200994,1,2,2,3,6,11,REDACTED
7200994,2,8,7,3,4,14,REDACTED
7200994,3,4,12,3,0,15,REDACTED
7204117,1,2,8,6,0,14,REDACTED
7204117,2,0,0,0,0,0,REDACTED
7204620,1,8,7,7,0,14,REDACTED
7204696,1,2,6,23,26,55,REDACTED
7204745,1,6,5,4,6,15,REDACTED
7204745,2,12,14,0,4,18,REDACTED
7204792,1,6,7,2,6,15,REDACTED
7205120,1,7,9,0,8,17,REDACTED
7205120,2,2,1,7,6,14,REDACTED
7205120,3,3,0,1,1,2,REDACTED
7205247,1,5,6,4,3,13,REDACTED
7205425,1,6,4,4,3,11,REDACTED
7205425,2,6,7,4,3,14,REDACTED
7205504,1,8,10,6,5,21,REDACTED
7205504,2,0,0,0,0,0,REDACTED
7205671,1,6,6,5,6,17,REDACTED
7205671,2,9,9,9,9,27,REDACTED
7205698,1,3,0,0,0,0,REDACTED
7205698,2,0,0,0,0,0,REDACTED
7205698,3,0,0,0,0,0,REDACTED
7205850,1,0,3,1,0,4,REDACTED
7205850,2,10,18,20,16,54,REDACTED
7205905,1,5,5,4,2,11,REDACTED
7205905,2,6,9,8,4,21,REDACTED
7205958,1,6,7,4,4,15,REDACTED
7205958,2,5,7,12,11,30,REDACTED
7205958,3,7,5,2,2,9,REDACTED
7205976,1,6,9,0,0,9,REDACTED
7205976,2,4,10,0,0,10,REDACTED
7205976,3,4,10,0,0,10,REDACTED
7206017,1,5,11,4,3,18,REDACTED
7206017,2,3,3,4,0,7,REDACTED
7206162,1,4,6,3,5,14,REDACTED
7206162,2,2,5,0,9,14,REDACTED
7206162,3,2,4,5,2,11,REDACTED
7206162,4,2,2,0,0,2,REDACTED
7206204,1,16,16,4,8,28,REDACTED
7206204,2,13,13,4,8,25,REDACTED
7206229,1,11,11,9,0,20,REDACTED
7206336,1,8,9,7,12,28,REDACTED
7206336,2,5,5,0,3,8,REDACTED
7206369,1,0,0,2,5,7,REDACTED
7206369,2,2,4,2,0,6,REDACTED
7206384,1,0,0,0,0,0,REDACTED
7206495,1,6,3,2,0,5,REDACTED
7206495,2,8,7,10,5,22,REDACTED
7206641,1,12,13,11,12,36,REDACTED
7206641,2,13,16,12,9,37,REDACTED
7206650,1,8,7,8,0,15,REDACTED
7206650,2,7,10,6,0,16,REDACTED
7206650,3,7,8,4,6,18,REDACTED
7206773,1,7,6,5,3,14,REDACTED
7206834,1,11,11,7,8,26,REDACTED
7206834,2,11,3,10,8,21,REDACTED
7206974,1,5,5,9,14,28,REDACTED
7206974,2,5,8,9,12,29,REDACTED
7207127,1,4,4,4,3,11,REDACTED
7207237,1,10,6,0,0,6,REDACTED
7207237,2,3,6,0,0,6,REDACTED
7207254,1,4,4,4,0,8,REDACTED
7207254,2,4,4,3,2,9,REDACTED
7207254,3,3,0,0,0,0,REDACTED
7207254,4,3,0,0,0,0,REDACTED
7207462,1,7,17,0,5,22,REDACTED
7207533,1,3,3,6,4,13,REDACTED
7207533,2,2,3,5,5,13,REDACTED
7207615,1,2,4,4,0,8,REDACTED
7207615,2,2,2,1,2,5,REDACTED
7207615,3,8,9,7,0,16,REDACTED
7207615,4,0,0,0,0,0,REDACTED
7207615,5,2,6,0,0,6,REDACTED
7207615,6,10,16,10,0,26,REDACTED
7207670,1,3,3,6,5,14,REDACTED
7207760,1,5,5,6,9,20,REDACTED
7207760,2,2,2,3,5,10,REDACTED
7207774,1,2,3,3,3,9,REDACTED
7207774,2,7,9,8,10,27,REDACTED
7207897,1,6,6,4,7,17,REDACTED
7207925,1,10,8,4,4,16,REDACTED
7207925,2,10,10,7,2,19,REDACTED
7207934,1,0,0,0,0,0,REDACTED
7207940,1,2,2,2,4,8,REDACTED
7207940,2,0,3,3,0,6,REDACTED
7207940,3,3,3,4,2,9,REDACTED
7208114,1,2,3,8,0,11,REDACTED
7208114,2,5,3,3,0,6,REDACTED
7208372,1,9,10,6,4,20,REDACTED
7208372,2,6,8,9,3,20,REDACTED
7208372,3,6,0,8,0,8,REDACTED
7208372,4,2,5,5,0,10,REDACTED
7208527,1,2,2,0,0,2,REDACTED
7208527,2,2,6,0,0,6,REDACTED
7208527,3,2,0,0,0,0,REDACTED
7208633,1,11,11,13,13,37,REDACTED
7208633,2,6,6,8,4,18,REDACTED
7208654,1,7,8,6,7,21,REDACTED
7208682,1,6,3,2,6,11,REDACTED
7208706,1,7,5,9,1,15,REDACTED
7208706,2,0,0,0,0,0,REDACTED
7208757,1,8,3,6,12,21,REDACTED
7208757,2,6,7,3,5,15,REDACTED
7208830,1,9,10,8,10,28,REDACTED
7208830,2,6,8,2,6,16,REDACTED
7210241,1,0,0,0,2,2,REDACTED
7210241,2,2,2,2,8,12,REDACTED
7210303,1,4,4,7,5,16,REDACTED
7210303,2,6,7,7,3,17,REDACTED
7210303,3,2,3,2,19,24,REDACTED
7210317,1,0,2,0,0,2,REDACTED
7210317,2,4,6,10,0,16,REDACTED
7210317,3,6,2,0,0,2,REDACTED
7210481,1,12,12,10,11,33,REDACTED
7210481,2,18,18,7,5,30,REDACTED
7210493,1,6,4,8,5,17,REDACTED
7210493,2,5,11,6,7,24,REDACTED
7210833,1,4,4,0,0,4,REDACTED
7210833,2,4,2,0,0,2,REDACTED
7210833,3,5,8,0,0,8,REDACTED
7210856,1,5,5,0,0,5,REDACTED
7210856,2,12,11,0,0,11,REDACTED
7210943,1,13,18,21,14,53,REDACTED
7210943,2,4,9,5,0,14,REDACTED
7210943,3,4,7,7,0,14,REDACTED
7210995,1,6,10,3,8,21,REDACTED
7210995,2,2,2,3,16,21,REDACTED
7210995,3,0,0,7,8,15,REDACTED
7211076,1,2,5,4,3,12,REDACTED
7211076,2,2,5,0,0,5,REDACTED
7211087,1,2,5,2,1,8,REDACTED
7211087,2,8,8,3,0,11,REDACTED
7211308,1,3,5,8,2,15,REDACTED
7211308,2,9,10,15,2,27,REDACTED
7211308,3,0,0,13,0,13,REDACTED
7211426,1,2,2,0,0,2,REDACTED
7211426,2,2,2,0,0,2,REDACTED
7211505,1,5,4,5,5,14,REDACTED
7211505,2,2,2,0,0,2,REDACTED
7211505,3,5,5,3,5,13,REDACTED
7211523,1,5,3,8,3,14,REDACTED
7211523,2,3,0,0,0,0,REDACTED
7211523,3,0,0,0,0,0,REDACTED
7211560,1,9,12,13,3,28,REDACTED
7211560,2,10,13,12,16,41,REDACTED
